away,away_score,diff_score,game_id,home,home_score,round_num,time
BKN,3,3,BKN-TOR-1,TOR,0,1,0.0
BKN,3,3,BKN-TOR-1,TOR,0,1,0.25
BKN,5,5,BKN-TOR-1,TOR,0,1,0.5
BKN,5,5,BKN-TOR-1,TOR,0,1,0.75
BKN,5,5,BKN-TOR-1,TOR,0,1,1.0
BKN,5,5,BKN-TOR-1,TOR,0,1,1.25
BKN,5,5,BKN-TOR-1,TOR,0,1,1.5
BKN,5,3,BKN-TOR-1,TOR,2,1,1.75
BKN,5,3,BKN-TOR-1,TOR,2,1,2.0
BKN,5,3,BKN-TOR-1,TOR,2,1,2.25
BKN,5,1,BKN-TOR-1,TOR,4,1,2.5
BKN,5,1,BKN-TOR-1,TOR,4,1,2.75
BKN,5,1,BKN-TOR-1,TOR,4,1,3.0
BKN,6,2,BKN-TOR-1,TOR,4,1,3.25
BKN,6,2,BKN-TOR-1,TOR,4,1,3.5
BKN,6,2,BKN-TOR-1,TOR,4,1,3.75
BKN,6,2,BKN-TOR-1,TOR,4,1,4.0
BKN,6,2,BKN-TOR-1,TOR,4,1,4.25
BKN,7,2,BKN-TOR-1,TOR,5,1,4.5
BKN,7,-1,BKN-TOR-1,TOR,8,1,4.75
BKN,7,-1,BKN-TOR-1,TOR,8,1,5.0
BKN,7,-4,BKN-TOR-1,TOR,11,1,5.25
BKN,7,-4,BKN-TOR-1,TOR,11,1,5.5
BKN,9,-2,BKN-TOR-1,TOR,11,1,5.75
BKN,11,0,BKN-TOR-1,TOR,11,1,6.0
BKN,11,0,BKN-TOR-1,TOR,11,1,6.25
BKN,13,2,BKN-TOR-1,TOR,11,1,6.5
BKN,13,2,BKN-TOR-1,TOR,11,1,6.75
BKN,16,5,BKN-TOR-1,TOR,11,1,7.0
BKN,16,5,BKN-TOR-1,TOR,11,1,7.25
BKN,16,5,BKN-TOR-1,TOR,11,1,7.5
BKN,19,8,BKN-TOR-1,TOR,11,1,7.75
BKN,19,8,BKN-TOR-1,TOR,11,1,8.0
BKN,19,6,BKN-TOR-1,TOR,13,1,8.25
BKN,21,8,BKN-TOR-1,TOR,13,1,8.5
BKN,25,12,BKN-TOR-1,TOR,13,1,8.75
BKN,25,12,BKN-TOR-1,TOR,13,1,9.0
BKN,25,11,BKN-TOR-1,TOR,14,1,9.25
BKN,25,9,BKN-TOR-1,TOR,16,1,9.5
BKN,25,7,BKN-TOR-1,TOR,18,1,9.75
BKN,27,9,BKN-TOR-1,TOR,18,1,10.0
BKN,27,9,BKN-TOR-1,TOR,18,1,10.25
BKN,28,10,BKN-TOR-1,TOR,18,1,10.5
BKN,28,10,BKN-TOR-1,TOR,18,1,10.75
BKN,29,8,BKN-TOR-1,TOR,21,1,11.0
BKN,29,8,BKN-TOR-1,TOR,21,1,11.25
BKN,29,8,BKN-TOR-1,TOR,21,1,11.5
BKN,29,8,BKN-TOR-1,TOR,21,1,11.75
BKN,29,8,BKN-TOR-1,TOR,21,1,12.0
BKN,29,8,BKN-TOR-1,TOR,21,1,12.25
BKN,29,8,BKN-TOR-1,TOR,21,1,12.5
BKN,29,8,BKN-TOR-1,TOR,21,1,12.75
BKN,29,8,BKN-TOR-1,TOR,21,1,13.0
BKN,29,8,BKN-TOR-1,TOR,21,1,13.25
BKN,29,8,BKN-TOR-1,TOR,21,1,13.5
BKN,29,8,BKN-TOR-1,TOR,21,1,13.75
BKN,29,8,BKN-TOR-1,TOR,21,1,14.0
BKN,29,8,BKN-TOR-1,TOR,21,1,14.25
BKN,29,8,BKN-TOR-1,TOR,21,1,14.5
BKN,29,8,BKN-TOR-1,TOR,21,1,14.75
BKN,29,8,BKN-TOR-1,TOR,21,1,15.0
BKN,29,8,BKN-TOR-1,TOR,21,1,15.25
BKN,29,8,BKN-TOR-1,TOR,21,1,15.5
BKN,29,8,BKN-TOR-1,TOR,21,1,15.75
BKN,29,8,BKN-TOR-1,TOR,21,1,16.0
BKN,29,8,BKN-TOR-1,TOR,21,1,16.25
BKN,29,8,BKN-TOR-1,TOR,21,1,16.5
BKN,29,8,BKN-TOR-1,TOR,21,1,16.75
BKN,29,8,BKN-TOR-1,TOR,21,1,17.0
BKN,29,8,BKN-TOR-1,TOR,21,1,17.25
BKN,29,8,BKN-TOR-1,TOR,21,1,17.5
BKN,29,8,BKN-TOR-1,TOR,21,1,17.75
BKN,29,8,BKN-TOR-1,TOR,21,1,18.0
BKN,29,8,BKN-TOR-1,TOR,21,1,18.25
BKN,29,8,BKN-TOR-1,TOR,21,1,18.5
BKN,29,8,BKN-TOR-1,TOR,21,1,18.75
BKN,29,8,BKN-TOR-1,TOR,21,1,19.0
BKN,29,8,BKN-TOR-1,TOR,21,1,19.25
BKN,29,8,BKN-TOR-1,TOR,21,1,19.5
BKN,29,8,BKN-TOR-1,TOR,21,1,19.75
BKN,29,8,BKN-TOR-1,TOR,21,1,20.0
BKN,29,8,BKN-TOR-1,TOR,21,1,20.25
BKN,29,8,BKN-TOR-1,TOR,21,1,20.5
BKN,29,8,BKN-TOR-1,TOR,21,1,20.75
BKN,29,8,BKN-TOR-1,TOR,21,1,21.0
BKN,29,8,BKN-TOR-1,TOR,21,1,21.25
BKN,29,8,BKN-TOR-1,TOR,21,1,21.5
BKN,29,8,BKN-TOR-1,TOR,21,1,21.75
BKN,29,8,BKN-TOR-1,TOR,21,1,22.0
BKN,29,8,BKN-TOR-1,TOR,21,1,22.25
BKN,29,8,BKN-TOR-1,TOR,21,1,22.5
BKN,29,8,BKN-TOR-1,TOR,21,1,22.75
BKN,29,8,BKN-TOR-1,TOR,21,1,23.0
BKN,29,8,BKN-TOR-1,TOR,21,1,23.25
BKN,29,8,BKN-TOR-1,TOR,21,1,23.5
BKN,29,8,BKN-TOR-1,TOR,21,1,23.75
BKN,29,8,BKN-TOR-1,TOR,21,1,24.0
BKN,29,8,BKN-TOR-1,TOR,21,1,24.25
BKN,29,8,BKN-TOR-1,TOR,21,1,24.5
BKN,29,8,BKN-TOR-1,TOR,21,1,24.75
BKN,29,8,BKN-TOR-1,TOR,21,1,25.0
BKN,29,8,BKN-TOR-1,TOR,21,1,25.25
BKN,29,8,BKN-TOR-1,TOR,21,1,25.5
BKN,29,8,BKN-TOR-1,TOR,21,1,25.75
BKN,29,8,BKN-TOR-1,TOR,21,1,26.0
BKN,29,8,BKN-TOR-1,TOR,21,1,26.25
BKN,29,8,BKN-TOR-1,TOR,21,1,26.5
BKN,29,8,BKN-TOR-1,TOR,21,1,26.75
BKN,29,8,BKN-TOR-1,TOR,21,1,27.0
BKN,29,8,BKN-TOR-1,TOR,21,1,27.25
BKN,29,8,BKN-TOR-1,TOR,21,1,27.5
BKN,29,8,BKN-TOR-1,TOR,21,1,27.75
BKN,29,8,BKN-TOR-1,TOR,21,1,28.0
BKN,29,8,BKN-TOR-1,TOR,21,1,28.25
BKN,29,8,BKN-TOR-1,TOR,21,1,28.5
BKN,29,8,BKN-TOR-1,TOR,21,1,28.75
BKN,29,8,BKN-TOR-1,TOR,21,1,29.0
BKN,29,8,BKN-TOR-1,TOR,21,1,29.25
BKN,29,8,BKN-TOR-1,TOR,21,1,29.5
BKN,29,8,BKN-TOR-1,TOR,21,1,29.75
BKN,29,8,BKN-TOR-1,TOR,21,1,30.0
BKN,29,8,BKN-TOR-1,TOR,21,1,30.25
BKN,29,8,BKN-TOR-1,TOR,21,1,30.5
BKN,29,8,BKN-TOR-1,TOR,21,1,30.75
BKN,29,8,BKN-TOR-1,TOR,21,1,31.0
BKN,29,8,BKN-TOR-1,TOR,21,1,31.25
BKN,29,8,BKN-TOR-1,TOR,21,1,31.5
BKN,29,8,BKN-TOR-1,TOR,21,1,31.75
BKN,29,8,BKN-TOR-1,TOR,21,1,32.0
BKN,29,8,BKN-TOR-1,TOR,21,1,32.25
BKN,29,8,BKN-TOR-1,TOR,21,1,32.5
BKN,29,8,BKN-TOR-1,TOR,21,1,32.75
BKN,29,8,BKN-TOR-1,TOR,21,1,33.0
BKN,29,8,BKN-TOR-1,TOR,21,1,33.25
BKN,29,8,BKN-TOR-1,TOR,21,1,33.5
BKN,29,8,BKN-TOR-1,TOR,21,1,33.75
BKN,29,8,BKN-TOR-1,TOR,21,1,34.0
BKN,29,8,BKN-TOR-1,TOR,21,1,34.25
BKN,29,8,BKN-TOR-1,TOR,21,1,34.5
BKN,29,8,BKN-TOR-1,TOR,21,1,34.75
BKN,29,8,BKN-TOR-1,TOR,21,1,35.0
BKN,29,8,BKN-TOR-1,TOR,21,1,35.25
BKN,29,8,BKN-TOR-1,TOR,21,1,35.5
BKN,29,8,BKN-TOR-1,TOR,21,1,35.75
BKN,29,8,BKN-TOR-1,TOR,21,1,36.0
BKN,29,8,BKN-TOR-1,TOR,21,1,36.25
BKN,29,8,BKN-TOR-1,TOR,21,1,36.5
BKN,29,8,BKN-TOR-1,TOR,21,1,36.75
BKN,29,8,BKN-TOR-1,TOR,21,1,37.0
BKN,29,8,BKN-TOR-1,TOR,21,1,37.25
BKN,29,8,BKN-TOR-1,TOR,21,1,37.5
BKN,29,8,BKN-TOR-1,TOR,21,1,37.75
BKN,29,8,BKN-TOR-1,TOR,21,1,38.0
BKN,29,8,BKN-TOR-1,TOR,21,1,38.25
BKN,29,8,BKN-TOR-1,TOR,21,1,38.5
BKN,29,8,BKN-TOR-1,TOR,21,1,38.75
BKN,29,8,BKN-TOR-1,TOR,21,1,39.0
BKN,29,8,BKN-TOR-1,TOR,21,1,39.25
BKN,29,8,BKN-TOR-1,TOR,21,1,39.5
BKN,29,8,BKN-TOR-1,TOR,21,1,39.75
BKN,29,8,BKN-TOR-1,TOR,21,1,40.0
BKN,29,8,BKN-TOR-1,TOR,21,1,40.25
BKN,29,8,BKN-TOR-1,TOR,21,1,40.5
BKN,29,8,BKN-TOR-1,TOR,21,1,40.75
BKN,29,8,BKN-TOR-1,TOR,21,1,41.0
BKN,29,8,BKN-TOR-1,TOR,21,1,41.25
BKN,29,8,BKN-TOR-1,TOR,21,1,41.5
BKN,29,8,BKN-TOR-1,TOR,21,1,41.75
BKN,29,8,BKN-TOR-1,TOR,21,1,42.0
BKN,29,8,BKN-TOR-1,TOR,21,1,42.25
BKN,29,8,BKN-TOR-1,TOR,21,1,42.5
BKN,29,8,BKN-TOR-1,TOR,21,1,42.75
BKN,29,8,BKN-TOR-1,TOR,21,1,43.0
BKN,29,8,BKN-TOR-1,TOR,21,1,43.25
BKN,29,8,BKN-TOR-1,TOR,21,1,43.5
BKN,29,8,BKN-TOR-1,TOR,21,1,43.75
BKN,29,8,BKN-TOR-1,TOR,21,1,44.0
BKN,29,8,BKN-TOR-1,TOR,21,1,44.25
BKN,29,8,BKN-TOR-1,TOR,21,1,44.5
BKN,29,8,BKN-TOR-1,TOR,21,1,44.75
BKN,29,8,BKN-TOR-1,TOR,21,1,45.0
BKN,29,8,BKN-TOR-1,TOR,21,1,45.25
BKN,29,8,BKN-TOR-1,TOR,21,1,45.5
BKN,29,8,BKN-TOR-1,TOR,21,1,45.75
BKN,29,8,BKN-TOR-1,TOR,21,1,46.0
BKN,29,8,BKN-TOR-1,TOR,21,1,46.25
BKN,29,8,BKN-TOR-1,TOR,21,1,46.5
BKN,29,8,BKN-TOR-1,TOR,21,1,46.75
BKN,29,8,BKN-TOR-1,TOR,21,1,47.0
BKN,29,8,BKN-TOR-1,TOR,21,1,47.25
BKN,29,8,BKN-TOR-1,TOR,21,1,47.5
BKN,29,8,BKN-TOR-1,TOR,21,1,47.75
BKN,29,8,BKN-TOR-1,TOR,21,1,48.0
BKN,29,8,BKN-TOR-1,TOR,21,1,48.25
BKN,29,8,BKN-TOR-1,TOR,21,1,48.5
BKN,29,8,BKN-TOR-1,TOR,21,1,48.75
GS,0,-2,GS-LAC-1,LAC,2,1,0.0
GS,0,-2,GS-LAC-1,LAC,2,1,0.25
GS,0,-2,GS-LAC-1,LAC,2,1,0.5
GS,0,-2,GS-LAC-1,LAC,2,1,0.75
GS,0,-5,GS-LAC-1,LAC,5,1,1.0
GS,0,-5,GS-LAC-1,LAC,5,1,1.25
GS,0,-5,GS-LAC-1,LAC,5,1,1.5
GS,0,-7,GS-LAC-1,LAC,7,1,1.75
GS,0,-7,GS-LAC-1,LAC,7,1,2.0
GS,0,-7,GS-LAC-1,LAC,7,1,2.25
GS,1,-6,GS-LAC-1,LAC,7,1,2.5
GS,1,-7,GS-LAC-1,LAC,8,1,2.75
GS,1,-8,GS-LAC-1,LAC,9,1,3.0
GS,1,-11,GS-LAC-1,LAC,12,1,3.25
GS,1,-11,GS-LAC-1,LAC,12,1,3.5
GS,1,-11,GS-LAC-1,LAC,12,1,3.75
GS,1,-11,GS-LAC-1,LAC,12,1,4.0
GS,3,-9,GS-LAC-1,LAC,12,1,4.25
GS,5,-7,GS-LAC-1,LAC,12,1,4.5
GS,5,-7,GS-LAC-1,LAC,12,1,4.75
GS,5,-10,GS-LAC-1,LAC,15,1,5.0
GS,8,-7,GS-LAC-1,LAC,15,1,5.25
GS,10,-5,GS-LAC-1,LAC,15,1,5.5
GS,10,-5,GS-LAC-1,LAC,15,1,5.75
GS,10,-5,GS-LAC-1,LAC,15,1,6.0
GS,10,-5,GS-LAC-1,LAC,15,1,6.25
GS,10,-5,GS-LAC-1,LAC,15,1,6.5
GS,10,-5,GS-LAC-1,LAC,15,1,6.75
GS,12,-3,GS-LAC-1,LAC,15,1,7.0
GS,12,-3,GS-LAC-1,LAC,15,1,7.25
GS,14,-1,GS-LAC-1,LAC,15,1,7.5
GS,14,-1,GS-LAC-1,LAC,15,1,7.75
GS,14,-1,GS-LAC-1,LAC,15,1,8.0
GS,14,-2,GS-LAC-1,LAC,16,1,8.25
GS,17,0,GS-LAC-1,LAC,17,1,8.5
GS,17,-2,GS-LAC-1,LAC,19,1,8.75
GS,17,-3,GS-LAC-1,LAC,20,1,9.0
GS,20,0,GS-LAC-1,LAC,20,1,9.25
GS,20,0,GS-LAC-1,LAC,20,1,9.5
GS,20,-2,GS-LAC-1,LAC,22,1,9.75
GS,20,-4,GS-LAC-1,LAC,24,1,10.0
GS,20,-4,GS-LAC-1,LAC,24,1,10.25
GS,20,-6,GS-LAC-1,LAC,26,1,10.5
GS,22,-4,GS-LAC-1,LAC,26,1,10.75
GS,24,-2,GS-LAC-1,LAC,26,1,11.0
GS,24,-2,GS-LAC-1,LAC,26,1,11.25
GS,24,-2,GS-LAC-1,LAC,26,1,11.5
GS,24,-2,GS-LAC-1,LAC,26,1,11.75
GS,24,-5,GS-LAC-1,LAC,29,1,12.0
GS,24,-5,GS-LAC-1,LAC,29,1,12.25
GS,24,-5,GS-LAC-1,LAC,29,1,12.5
GS,24,-5,GS-LAC-1,LAC,29,1,12.75
GS,24,-5,GS-LAC-1,LAC,29,1,13.0
GS,24,-5,GS-LAC-1,LAC,29,1,13.25
GS,24,-5,GS-LAC-1,LAC,29,1,13.5
GS,24,-5,GS-LAC-1,LAC,29,1,13.75
GS,24,-5,GS-LAC-1,LAC,29,1,14.0
GS,24,-5,GS-LAC-1,LAC,29,1,14.25
GS,24,-5,GS-LAC-1,LAC,29,1,14.5
GS,24,-5,GS-LAC-1,LAC,29,1,14.75
GS,24,-5,GS-LAC-1,LAC,29,1,15.0
GS,24,-5,GS-LAC-1,LAC,29,1,15.25
GS,24,-5,GS-LAC-1,LAC,29,1,15.5
GS,24,-5,GS-LAC-1,LAC,29,1,15.75
GS,24,-5,GS-LAC-1,LAC,29,1,16.0
GS,24,-5,GS-LAC-1,LAC,29,1,16.25
GS,24,-5,GS-LAC-1,LAC,29,1,16.5
GS,24,-5,GS-LAC-1,LAC,29,1,16.75
GS,24,-5,GS-LAC-1,LAC,29,1,17.0
GS,24,-5,GS-LAC-1,LAC,29,1,17.25
GS,24,-5,GS-LAC-1,LAC,29,1,17.5
GS,24,-5,GS-LAC-1,LAC,29,1,17.75
GS,24,-5,GS-LAC-1,LAC,29,1,18.0
GS,24,-5,GS-LAC-1,LAC,29,1,18.25
GS,24,-5,GS-LAC-1,LAC,29,1,18.5
GS,24,-5,GS-LAC-1,LAC,29,1,18.75
GS,24,-5,GS-LAC-1,LAC,29,1,19.0
GS,24,-5,GS-LAC-1,LAC,29,1,19.25
GS,24,-5,GS-LAC-1,LAC,29,1,19.5
GS,24,-5,GS-LAC-1,LAC,29,1,19.75
GS,24,-5,GS-LAC-1,LAC,29,1,20.0
GS,24,-5,GS-LAC-1,LAC,29,1,20.25
GS,24,-5,GS-LAC-1,LAC,29,1,20.5
GS,24,-5,GS-LAC-1,LAC,29,1,20.75
GS,24,-5,GS-LAC-1,LAC,29,1,21.0
GS,24,-5,GS-LAC-1,LAC,29,1,21.25
GS,24,-5,GS-LAC-1,LAC,29,1,21.5
GS,24,-5,GS-LAC-1,LAC,29,1,21.75
GS,24,-5,GS-LAC-1,LAC,29,1,22.0
GS,24,-5,GS-LAC-1,LAC,29,1,22.25
GS,24,-5,GS-LAC-1,LAC,29,1,22.5
GS,24,-5,GS-LAC-1,LAC,29,1,22.75
GS,24,-5,GS-LAC-1,LAC,29,1,23.0
GS,24,-5,GS-LAC-1,LAC,29,1,23.25
GS,24,-5,GS-LAC-1,LAC,29,1,23.5
GS,24,-5,GS-LAC-1,LAC,29,1,23.75
GS,24,-5,GS-LAC-1,LAC,29,1,24.0
GS,24,-5,GS-LAC-1,LAC,29,1,24.25
GS,24,-5,GS-LAC-1,LAC,29,1,24.5
GS,24,-5,GS-LAC-1,LAC,29,1,24.75
GS,24,-5,GS-LAC-1,LAC,29,1,25.0
GS,24,-5,GS-LAC-1,LAC,29,1,25.25
GS,24,-5,GS-LAC-1,LAC,29,1,25.5
GS,24,-5,GS-LAC-1,LAC,29,1,25.75
GS,24,-5,GS-LAC-1,LAC,29,1,26.0
GS,24,-5,GS-LAC-1,LAC,29,1,26.25
GS,24,-5,GS-LAC-1,LAC,29,1,26.5
GS,24,-5,GS-LAC-1,LAC,29,1,26.75
GS,24,-5,GS-LAC-1,LAC,29,1,27.0
GS,24,-5,GS-LAC-1,LAC,29,1,27.25
GS,24,-5,GS-LAC-1,LAC,29,1,27.5
GS,24,-5,GS-LAC-1,LAC,29,1,27.75
GS,24,-5,GS-LAC-1,LAC,29,1,28.0
GS,24,-5,GS-LAC-1,LAC,29,1,28.25
GS,24,-5,GS-LAC-1,LAC,29,1,28.5
GS,24,-5,GS-LAC-1,LAC,29,1,28.75
GS,24,-5,GS-LAC-1,LAC,29,1,29.0
GS,24,-5,GS-LAC-1,LAC,29,1,29.25
GS,24,-5,GS-LAC-1,LAC,29,1,29.5
GS,24,-5,GS-LAC-1,LAC,29,1,29.75
GS,24,-5,GS-LAC-1,LAC,29,1,30.0
GS,24,-5,GS-LAC-1,LAC,29,1,30.25
GS,24,-5,GS-LAC-1,LAC,29,1,30.5
GS,24,-5,GS-LAC-1,LAC,29,1,30.75
GS,24,-5,GS-LAC-1,LAC,29,1,31.0
GS,24,-5,GS-LAC-1,LAC,29,1,31.25
GS,24,-5,GS-LAC-1,LAC,29,1,31.5
GS,24,-5,GS-LAC-1,LAC,29,1,31.75
GS,24,-5,GS-LAC-1,LAC,29,1,32.0
GS,24,-5,GS-LAC-1,LAC,29,1,32.25
GS,24,-5,GS-LAC-1,LAC,29,1,32.5
GS,24,-5,GS-LAC-1,LAC,29,1,32.75
GS,24,-5,GS-LAC-1,LAC,29,1,33.0
GS,24,-5,GS-LAC-1,LAC,29,1,33.25
GS,24,-5,GS-LAC-1,LAC,29,1,33.5
GS,24,-5,GS-LAC-1,LAC,29,1,33.75
GS,24,-5,GS-LAC-1,LAC,29,1,34.0
GS,24,-5,GS-LAC-1,LAC,29,1,34.25
GS,24,-5,GS-LAC-1,LAC,29,1,34.5
GS,24,-5,GS-LAC-1,LAC,29,1,34.75
GS,24,-5,GS-LAC-1,LAC,29,1,35.0
GS,24,-5,GS-LAC-1,LAC,29,1,35.25
GS,24,-5,GS-LAC-1,LAC,29,1,35.5
GS,24,-5,GS-LAC-1,LAC,29,1,35.75
GS,24,-5,GS-LAC-1,LAC,29,1,36.0
GS,24,-5,GS-LAC-1,LAC,29,1,36.25
GS,24,-5,GS-LAC-1,LAC,29,1,36.5
GS,24,-5,GS-LAC-1,LAC,29,1,36.75
GS,24,-5,GS-LAC-1,LAC,29,1,37.0
GS,24,-5,GS-LAC-1,LAC,29,1,37.25
GS,24,-5,GS-LAC-1,LAC,29,1,37.5
GS,24,-5,GS-LAC-1,LAC,29,1,37.75
GS,24,-5,GS-LAC-1,LAC,29,1,38.0
GS,24,-5,GS-LAC-1,LAC,29,1,38.25
GS,24,-5,GS-LAC-1,LAC,29,1,38.5
GS,24,-5,GS-LAC-1,LAC,29,1,38.75
GS,24,-5,GS-LAC-1,LAC,29,1,39.0
GS,24,-5,GS-LAC-1,LAC,29,1,39.25
GS,24,-5,GS-LAC-1,LAC,29,1,39.5
GS,24,-5,GS-LAC-1,LAC,29,1,39.75
GS,24,-5,GS-LAC-1,LAC,29,1,40.0
GS,24,-5,GS-LAC-1,LAC,29,1,40.25
GS,24,-5,GS-LAC-1,LAC,29,1,40.5
GS,24,-5,GS-LAC-1,LAC,29,1,40.75
GS,24,-5,GS-LAC-1,LAC,29,1,41.0
GS,24,-5,GS-LAC-1,LAC,29,1,41.25
GS,24,-5,GS-LAC-1,LAC,29,1,41.5
GS,24,-5,GS-LAC-1,LAC,29,1,41.75
GS,24,-5,GS-LAC-1,LAC,29,1,42.0
GS,24,-5,GS-LAC-1,LAC,29,1,42.25
GS,24,-5,GS-LAC-1,LAC,29,1,42.5
GS,24,-5,GS-LAC-1,LAC,29,1,42.75
GS,24,-5,GS-LAC-1,LAC,29,1,43.0
GS,24,-5,GS-LAC-1,LAC,29,1,43.25
GS,24,-5,GS-LAC-1,LAC,29,1,43.5
GS,24,-5,GS-LAC-1,LAC,29,1,43.75
GS,24,-5,GS-LAC-1,LAC,29,1,44.0
GS,24,-5,GS-LAC-1,LAC,29,1,44.25
GS,24,-5,GS-LAC-1,LAC,29,1,44.5
GS,24,-5,GS-LAC-1,LAC,29,1,44.75
GS,24,-5,GS-LAC-1,LAC,29,1,45.0
GS,24,-5,GS-LAC-1,LAC,29,1,45.25
GS,24,-5,GS-LAC-1,LAC,29,1,45.5
GS,24,-5,GS-LAC-1,LAC,29,1,45.75
GS,24,-5,GS-LAC-1,LAC,29,1,46.0
GS,24,-5,GS-LAC-1,LAC,29,1,46.25
GS,24,-5,GS-LAC-1,LAC,29,1,46.5
GS,24,-5,GS-LAC-1,LAC,29,1,46.75
GS,24,-5,GS-LAC-1,LAC,29,1,47.0
GS,24,-5,GS-LAC-1,LAC,29,1,47.25
GS,24,-5,GS-LAC-1,LAC,29,1,47.5
GS,24,-5,GS-LAC-1,LAC,29,1,47.75
GS,24,-5,GS-LAC-1,LAC,29,1,48.0
GS,24,-5,GS-LAC-1,LAC,29,1,48.25
GS,24,-5,GS-LAC-1,LAC,29,1,48.5
GS,24,-5,GS-LAC-1,LAC,29,1,48.75
ATL,0,-2,ATL-IND-1,IND,2,1,0.0
ATL,0,-4,ATL-IND-1,IND,4,1,0.25
ATL,0,-4,ATL-IND-1,IND,4,1,0.5
ATL,2,-2,ATL-IND-1,IND,4,1,0.75
ATL,2,-2,ATL-IND-1,IND,4,1,1.0
ATL,2,-3,ATL-IND-1,IND,5,1,1.25
ATL,2,-5,ATL-IND-1,IND,7,1,1.5
ATL,2,-5,ATL-IND-1,IND,7,1,1.75
ATL,5,-2,ATL-IND-1,IND,7,1,2.0
ATL,7,0,ATL-IND-1,IND,7,1,2.25
ATL,7,0,ATL-IND-1,IND,7,1,2.5
ATL,10,3,ATL-IND-1,IND,7,1,2.75
ATL,10,3,ATL-IND-1,IND,7,1,3.0
ATL,10,3,ATL-IND-1,IND,7,1,3.25
ATL,10,3,ATL-IND-1,IND,7,1,3.5
ATL,10,3,ATL-IND-1,IND,7,1,3.75
ATL,10,3,ATL-IND-1,IND,7,1,4.0
ATL,13,6,ATL-IND-1,IND,7,1,4.25
ATL,13,6,ATL-IND-1,IND,7,1,4.5
ATL,13,4,ATL-IND-1,IND,9,1,4.75
ATL,13,4,ATL-IND-1,IND,9,1,5.0
ATL,16,7,ATL-IND-1,IND,9,1,5.25
ATL,16,7,ATL-IND-1,IND,9,1,5.5
ATL,16,7,ATL-IND-1,IND,9,1,5.75
ATL,16,7,ATL-IND-1,IND,9,1,6.0
ATL,18,9,ATL-IND-1,IND,9,1,6.25
ATL,18,9,ATL-IND-1,IND,9,1,6.5
ATL,18,9,ATL-IND-1,IND,9,1,6.75
ATL,18,9,ATL-IND-1,IND,9,1,7.0
ATL,18,7,ATL-IND-1,IND,11,1,7.25
ATL,18,7,ATL-IND-1,IND,11,1,7.5
ATL,18,7,ATL-IND-1,IND,11,1,7.75
ATL,19,8,ATL-IND-1,IND,11,1,8.0
ATL,19,8,ATL-IND-1,IND,11,1,8.25
ATL,19,5,ATL-IND-1,IND,14,1,8.5
ATL,19,5,ATL-IND-1,IND,14,1,8.75
ATL,19,5,ATL-IND-1,IND,14,1,9.0
ATL,21,6,ATL-IND-1,IND,15,1,9.25
ATL,21,6,ATL-IND-1,IND,15,1,9.5
ATL,21,6,ATL-IND-1,IND,15,1,9.75
ATL,21,4,ATL-IND-1,IND,17,1,10.0
ATL,21,4,ATL-IND-1,IND,17,1,10.25
ATL,23,6,ATL-IND-1,IND,17,1,10.5
ATL,24,7,ATL-IND-1,IND,17,1,10.75
ATL,24,7,ATL-IND-1,IND,17,1,11.0
ATL,25,6,ATL-IND-1,IND,19,1,11.25
ATL,25,6,ATL-IND-1,IND,19,1,11.5
ATL,28,9,ATL-IND-1,IND,19,1,11.75
ATL,28,6,ATL-IND-1,IND,22,1,12.0
ATL,28,6,ATL-IND-1,IND,22,1,12.25
ATL,28,6,ATL-IND-1,IND,22,1,12.5
ATL,28,6,ATL-IND-1,IND,22,1,12.75
ATL,28,6,ATL-IND-1,IND,22,1,13.0
ATL,28,6,ATL-IND-1,IND,22,1,13.25
ATL,28,6,ATL-IND-1,IND,22,1,13.5
ATL,28,6,ATL-IND-1,IND,22,1,13.75
ATL,28,6,ATL-IND-1,IND,22,1,14.0
ATL,28,6,ATL-IND-1,IND,22,1,14.25
ATL,28,6,ATL-IND-1,IND,22,1,14.5
ATL,28,6,ATL-IND-1,IND,22,1,14.75
ATL,28,6,ATL-IND-1,IND,22,1,15.0
ATL,28,6,ATL-IND-1,IND,22,1,15.25
ATL,28,6,ATL-IND-1,IND,22,1,15.5
ATL,28,6,ATL-IND-1,IND,22,1,15.75
ATL,28,6,ATL-IND-1,IND,22,1,16.0
ATL,28,6,ATL-IND-1,IND,22,1,16.25
ATL,28,6,ATL-IND-1,IND,22,1,16.5
ATL,28,6,ATL-IND-1,IND,22,1,16.75
ATL,28,6,ATL-IND-1,IND,22,1,17.0
ATL,28,6,ATL-IND-1,IND,22,1,17.25
ATL,28,6,ATL-IND-1,IND,22,1,17.5
ATL,28,6,ATL-IND-1,IND,22,1,17.75
ATL,28,6,ATL-IND-1,IND,22,1,18.0
ATL,28,6,ATL-IND-1,IND,22,1,18.25
ATL,28,6,ATL-IND-1,IND,22,1,18.5
ATL,28,6,ATL-IND-1,IND,22,1,18.75
ATL,28,6,ATL-IND-1,IND,22,1,19.0
ATL,28,6,ATL-IND-1,IND,22,1,19.25
ATL,28,6,ATL-IND-1,IND,22,1,19.5
ATL,28,6,ATL-IND-1,IND,22,1,19.75
ATL,28,6,ATL-IND-1,IND,22,1,20.0
ATL,28,6,ATL-IND-1,IND,22,1,20.25
ATL,28,6,ATL-IND-1,IND,22,1,20.5
ATL,28,6,ATL-IND-1,IND,22,1,20.75
ATL,28,6,ATL-IND-1,IND,22,1,21.0
ATL,28,6,ATL-IND-1,IND,22,1,21.25
ATL,28,6,ATL-IND-1,IND,22,1,21.5
ATL,28,6,ATL-IND-1,IND,22,1,21.75
ATL,28,6,ATL-IND-1,IND,22,1,22.0
ATL,28,6,ATL-IND-1,IND,22,1,22.25
ATL,28,6,ATL-IND-1,IND,22,1,22.5
ATL,28,6,ATL-IND-1,IND,22,1,22.75
ATL,28,6,ATL-IND-1,IND,22,1,23.0
ATL,28,6,ATL-IND-1,IND,22,1,23.25
ATL,28,6,ATL-IND-1,IND,22,1,23.5
ATL,28,6,ATL-IND-1,IND,22,1,23.75
ATL,28,6,ATL-IND-1,IND,22,1,24.0
ATL,28,6,ATL-IND-1,IND,22,1,24.25
ATL,28,6,ATL-IND-1,IND,22,1,24.5
ATL,28,6,ATL-IND-1,IND,22,1,24.75
ATL,28,6,ATL-IND-1,IND,22,1,25.0
ATL,28,6,ATL-IND-1,IND,22,1,25.25
ATL,28,6,ATL-IND-1,IND,22,1,25.5
ATL,28,6,ATL-IND-1,IND,22,1,25.75
ATL,28,6,ATL-IND-1,IND,22,1,26.0
ATL,28,6,ATL-IND-1,IND,22,1,26.25
ATL,28,6,ATL-IND-1,IND,22,1,26.5
ATL,28,6,ATL-IND-1,IND,22,1,26.75
ATL,28,6,ATL-IND-1,IND,22,1,27.0
ATL,28,6,ATL-IND-1,IND,22,1,27.25
ATL,28,6,ATL-IND-1,IND,22,1,27.5
ATL,28,6,ATL-IND-1,IND,22,1,27.75
ATL,28,6,ATL-IND-1,IND,22,1,28.0
ATL,28,6,ATL-IND-1,IND,22,1,28.25
ATL,28,6,ATL-IND-1,IND,22,1,28.5
ATL,28,6,ATL-IND-1,IND,22,1,28.75
ATL,28,6,ATL-IND-1,IND,22,1,29.0
ATL,28,6,ATL-IND-1,IND,22,1,29.25
ATL,28,6,ATL-IND-1,IND,22,1,29.5
ATL,28,6,ATL-IND-1,IND,22,1,29.75
ATL,28,6,ATL-IND-1,IND,22,1,30.0
ATL,28,6,ATL-IND-1,IND,22,1,30.25
ATL,28,6,ATL-IND-1,IND,22,1,30.5
ATL,28,6,ATL-IND-1,IND,22,1,30.75
ATL,28,6,ATL-IND-1,IND,22,1,31.0
ATL,28,6,ATL-IND-1,IND,22,1,31.25
ATL,28,6,ATL-IND-1,IND,22,1,31.5
ATL,28,6,ATL-IND-1,IND,22,1,31.75
ATL,28,6,ATL-IND-1,IND,22,1,32.0
ATL,28,6,ATL-IND-1,IND,22,1,32.25
ATL,28,6,ATL-IND-1,IND,22,1,32.5
ATL,28,6,ATL-IND-1,IND,22,1,32.75
ATL,28,6,ATL-IND-1,IND,22,1,33.0
ATL,28,6,ATL-IND-1,IND,22,1,33.25
ATL,28,6,ATL-IND-1,IND,22,1,33.5
ATL,28,6,ATL-IND-1,IND,22,1,33.75
ATL,28,6,ATL-IND-1,IND,22,1,34.0
ATL,28,6,ATL-IND-1,IND,22,1,34.25
ATL,28,6,ATL-IND-1,IND,22,1,34.5
ATL,28,6,ATL-IND-1,IND,22,1,34.75
ATL,28,6,ATL-IND-1,IND,22,1,35.0
ATL,28,6,ATL-IND-1,IND,22,1,35.25
ATL,28,6,ATL-IND-1,IND,22,1,35.5
ATL,28,6,ATL-IND-1,IND,22,1,35.75
ATL,28,6,ATL-IND-1,IND,22,1,36.0
ATL,28,6,ATL-IND-1,IND,22,1,36.25
ATL,28,6,ATL-IND-1,IND,22,1,36.5
ATL,28,6,ATL-IND-1,IND,22,1,36.75
ATL,28,6,ATL-IND-1,IND,22,1,37.0
ATL,28,6,ATL-IND-1,IND,22,1,37.25
ATL,28,6,ATL-IND-1,IND,22,1,37.5
ATL,28,6,ATL-IND-1,IND,22,1,37.75
ATL,28,6,ATL-IND-1,IND,22,1,38.0
ATL,28,6,ATL-IND-1,IND,22,1,38.25
ATL,28,6,ATL-IND-1,IND,22,1,38.5
ATL,28,6,ATL-IND-1,IND,22,1,38.75
ATL,28,6,ATL-IND-1,IND,22,1,39.0
ATL,28,6,ATL-IND-1,IND,22,1,39.25
ATL,28,6,ATL-IND-1,IND,22,1,39.5
ATL,28,6,ATL-IND-1,IND,22,1,39.75
ATL,28,6,ATL-IND-1,IND,22,1,40.0
ATL,28,6,ATL-IND-1,IND,22,1,40.25
ATL,28,6,ATL-IND-1,IND,22,1,40.5
ATL,28,6,ATL-IND-1,IND,22,1,40.75
ATL,28,6,ATL-IND-1,IND,22,1,41.0
ATL,28,6,ATL-IND-1,IND,22,1,41.25
ATL,28,6,ATL-IND-1,IND,22,1,41.5
ATL,28,6,ATL-IND-1,IND,22,1,41.75
ATL,28,6,ATL-IND-1,IND,22,1,42.0
ATL,28,6,ATL-IND-1,IND,22,1,42.25
ATL,28,6,ATL-IND-1,IND,22,1,42.5
ATL,28,6,ATL-IND-1,IND,22,1,42.75
ATL,28,6,ATL-IND-1,IND,22,1,43.0
ATL,28,6,ATL-IND-1,IND,22,1,43.25
ATL,28,6,ATL-IND-1,IND,22,1,43.5
ATL,28,6,ATL-IND-1,IND,22,1,43.75
ATL,28,6,ATL-IND-1,IND,22,1,44.0
ATL,28,6,ATL-IND-1,IND,22,1,44.25
ATL,28,6,ATL-IND-1,IND,22,1,44.5
ATL,28,6,ATL-IND-1,IND,22,1,44.75
ATL,28,6,ATL-IND-1,IND,22,1,45.0
ATL,28,6,ATL-IND-1,IND,22,1,45.25
ATL,28,6,ATL-IND-1,IND,22,1,45.5
ATL,28,6,ATL-IND-1,IND,22,1,45.75
ATL,28,6,ATL-IND-1,IND,22,1,46.0
ATL,28,6,ATL-IND-1,IND,22,1,46.25
ATL,28,6,ATL-IND-1,IND,22,1,46.5
ATL,28,6,ATL-IND-1,IND,22,1,46.75
ATL,28,6,ATL-IND-1,IND,22,1,47.0
ATL,28,6,ATL-IND-1,IND,22,1,47.25
ATL,28,6,ATL-IND-1,IND,22,1,47.5
ATL,28,6,ATL-IND-1,IND,22,1,47.75
ATL,28,6,ATL-IND-1,IND,22,1,48.0
ATL,28,6,ATL-IND-1,IND,22,1,48.25
ATL,28,6,ATL-IND-1,IND,22,1,48.5
ATL,28,6,ATL-IND-1,IND,22,1,48.75
MEM,0,-2,MEM-OKC-1,OKC,2,1,0.0
MEM,0,-2,MEM-OKC-1,OKC,2,1,0.25
MEM,0,-2,MEM-OKC-1,OKC,2,1,0.5
MEM,0,-4,MEM-OKC-1,OKC,4,1,0.75
MEM,0,-6,MEM-OKC-1,OKC,6,1,1.0
MEM,0,-6,MEM-OKC-1,OKC,6,1,1.25
MEM,0,-8,MEM-OKC-1,OKC,8,1,1.5
MEM,0,-8,MEM-OKC-1,OKC,8,1,1.75
MEM,0,-8,MEM-OKC-1,OKC,8,1,2.0
MEM,0,-8,MEM-OKC-1,OKC,8,1,2.25
MEM,2,-6,MEM-OKC-1,OKC,8,1,2.5
MEM,2,-6,MEM-OKC-1,OKC,8,1,2.75
MEM,2,-8,MEM-OKC-1,OKC,10,1,3.0
MEM,2,-10,MEM-OKC-1,OKC,12,1,3.25
MEM,2,-10,MEM-OKC-1,OKC,12,1,3.5
MEM,2,-12,MEM-OKC-1,OKC,14,1,3.75
MEM,2,-12,MEM-OKC-1,OKC,14,1,4.0
MEM,3,-11,MEM-OKC-1,OKC,14,1,4.25
MEM,5,-9,MEM-OKC-1,OKC,14,1,4.5
MEM,5,-9,MEM-OKC-1,OKC,14,1,4.75
MEM,5,-10,MEM-OKC-1,OKC,15,1,5.0
MEM,5,-10,MEM-OKC-1,OKC,15,1,5.25
MEM,5,-10,MEM-OKC-1,OKC,15,1,5.5
MEM,7,-9,MEM-OKC-1,OKC,16,1,5.75
MEM,7,-9,MEM-OKC-1,OKC,16,1,6.0
MEM,8,-11,MEM-OKC-1,OKC,19,1,6.25
MEM,10,-9,MEM-OKC-1,OKC,19,1,6.5
MEM,10,-11,MEM-OKC-1,OKC,21,1,6.75
MEM,10,-11,MEM-OKC-1,OKC,21,1,7.0
MEM,10,-13,MEM-OKC-1,OKC,23,1,7.25
MEM,10,-13,MEM-OKC-1,OKC,23,1,7.5
MEM,10,-13,MEM-OKC-1,OKC,23,1,7.75
MEM,11,-12,MEM-OKC-1,OKC,23,1,8.0
MEM,11,-14,MEM-OKC-1,OKC,25,1,8.25
MEM,11,-14,MEM-OKC-1,OKC,25,1,8.5
MEM,11,-14,MEM-OKC-1,OKC,25,1,8.75
MEM,11,-14,MEM-OKC-1,OKC,25,1,9.0
MEM,11,-14,MEM-OKC-1,OKC,25,1,9.25
MEM,12,-13,MEM-OKC-1,OKC,25,1,9.5
MEM,12,-13,MEM-OKC-1,OKC,25,1,9.75
MEM,12,-13,MEM-OKC-1,OKC,25,1,10.0
MEM,13,-12,MEM-OKC-1,OKC,25,1,10.25
MEM,13,-12,MEM-OKC-1,OKC,25,1,10.5
MEM,14,-13,MEM-OKC-1,OKC,27,1,10.75
MEM,16,-11,MEM-OKC-1,OKC,27,1,11.0
MEM,16,-12,MEM-OKC-1,OKC,28,1,11.25
MEM,16,-13,MEM-OKC-1,OKC,29,1,11.5
MEM,16,-13,MEM-OKC-1,OKC,29,1,11.75
MEM,16,-13,MEM-OKC-1,OKC,29,1,12.0
MEM,16,-13,MEM-OKC-1,OKC,29,1,12.25
MEM,16,-13,MEM-OKC-1,OKC,29,1,12.5
MEM,16,-13,MEM-OKC-1,OKC,29,1,12.75
MEM,16,-13,MEM-OKC-1,OKC,29,1,13.0
MEM,16,-13,MEM-OKC-1,OKC,29,1,13.25
MEM,16,-13,MEM-OKC-1,OKC,29,1,13.5
MEM,16,-13,MEM-OKC-1,OKC,29,1,13.75
MEM,16,-13,MEM-OKC-1,OKC,29,1,14.0
MEM,16,-13,MEM-OKC-1,OKC,29,1,14.25
MEM,16,-13,MEM-OKC-1,OKC,29,1,14.5
MEM,16,-13,MEM-OKC-1,OKC,29,1,14.75
MEM,16,-13,MEM-OKC-1,OKC,29,1,15.0
MEM,16,-13,MEM-OKC-1,OKC,29,1,15.25
MEM,16,-13,MEM-OKC-1,OKC,29,1,15.5
MEM,16,-13,MEM-OKC-1,OKC,29,1,15.75
MEM,16,-13,MEM-OKC-1,OKC,29,1,16.0
MEM,16,-13,MEM-OKC-1,OKC,29,1,16.25
MEM,16,-13,MEM-OKC-1,OKC,29,1,16.5
MEM,16,-13,MEM-OKC-1,OKC,29,1,16.75
MEM,16,-13,MEM-OKC-1,OKC,29,1,17.0
MEM,16,-13,MEM-OKC-1,OKC,29,1,17.25
MEM,16,-13,MEM-OKC-1,OKC,29,1,17.5
MEM,16,-13,MEM-OKC-1,OKC,29,1,17.75
MEM,16,-13,MEM-OKC-1,OKC,29,1,18.0
MEM,16,-13,MEM-OKC-1,OKC,29,1,18.25
MEM,16,-13,MEM-OKC-1,OKC,29,1,18.5
MEM,16,-13,MEM-OKC-1,OKC,29,1,18.75
MEM,16,-13,MEM-OKC-1,OKC,29,1,19.0
MEM,16,-13,MEM-OKC-1,OKC,29,1,19.25
MEM,16,-13,MEM-OKC-1,OKC,29,1,19.5
MEM,16,-13,MEM-OKC-1,OKC,29,1,19.75
MEM,16,-13,MEM-OKC-1,OKC,29,1,20.0
MEM,16,-13,MEM-OKC-1,OKC,29,1,20.25
MEM,16,-13,MEM-OKC-1,OKC,29,1,20.5
MEM,16,-13,MEM-OKC-1,OKC,29,1,20.75
MEM,16,-13,MEM-OKC-1,OKC,29,1,21.0
MEM,16,-13,MEM-OKC-1,OKC,29,1,21.25
MEM,16,-13,MEM-OKC-1,OKC,29,1,21.5
MEM,16,-13,MEM-OKC-1,OKC,29,1,21.75
MEM,16,-13,MEM-OKC-1,OKC,29,1,22.0
MEM,16,-13,MEM-OKC-1,OKC,29,1,22.25
MEM,16,-13,MEM-OKC-1,OKC,29,1,22.5
MEM,16,-13,MEM-OKC-1,OKC,29,1,22.75
MEM,16,-13,MEM-OKC-1,OKC,29,1,23.0
MEM,16,-13,MEM-OKC-1,OKC,29,1,23.25
MEM,16,-13,MEM-OKC-1,OKC,29,1,23.5
MEM,16,-13,MEM-OKC-1,OKC,29,1,23.75
MEM,16,-13,MEM-OKC-1,OKC,29,1,24.0
MEM,16,-13,MEM-OKC-1,OKC,29,1,24.25
MEM,16,-13,MEM-OKC-1,OKC,29,1,24.5
MEM,16,-13,MEM-OKC-1,OKC,29,1,24.75
MEM,16,-13,MEM-OKC-1,OKC,29,1,25.0
MEM,16,-13,MEM-OKC-1,OKC,29,1,25.25
MEM,16,-13,MEM-OKC-1,OKC,29,1,25.5
MEM,16,-13,MEM-OKC-1,OKC,29,1,25.75
MEM,16,-13,MEM-OKC-1,OKC,29,1,26.0
MEM,16,-13,MEM-OKC-1,OKC,29,1,26.25
MEM,16,-13,MEM-OKC-1,OKC,29,1,26.5
MEM,16,-13,MEM-OKC-1,OKC,29,1,26.75
MEM,16,-13,MEM-OKC-1,OKC,29,1,27.0
MEM,16,-13,MEM-OKC-1,OKC,29,1,27.25
MEM,16,-13,MEM-OKC-1,OKC,29,1,27.5
MEM,16,-13,MEM-OKC-1,OKC,29,1,27.75
MEM,16,-13,MEM-OKC-1,OKC,29,1,28.0
MEM,16,-13,MEM-OKC-1,OKC,29,1,28.25
MEM,16,-13,MEM-OKC-1,OKC,29,1,28.5
MEM,16,-13,MEM-OKC-1,OKC,29,1,28.75
MEM,16,-13,MEM-OKC-1,OKC,29,1,29.0
MEM,16,-13,MEM-OKC-1,OKC,29,1,29.25
MEM,16,-13,MEM-OKC-1,OKC,29,1,29.5
MEM,16,-13,MEM-OKC-1,OKC,29,1,29.75
MEM,16,-13,MEM-OKC-1,OKC,29,1,30.0
MEM,16,-13,MEM-OKC-1,OKC,29,1,30.25
MEM,16,-13,MEM-OKC-1,OKC,29,1,30.5
MEM,16,-13,MEM-OKC-1,OKC,29,1,30.75
MEM,16,-13,MEM-OKC-1,OKC,29,1,31.0
MEM,16,-13,MEM-OKC-1,OKC,29,1,31.25
MEM,16,-13,MEM-OKC-1,OKC,29,1,31.5
MEM,16,-13,MEM-OKC-1,OKC,29,1,31.75
MEM,16,-13,MEM-OKC-1,OKC,29,1,32.0
MEM,16,-13,MEM-OKC-1,OKC,29,1,32.25
MEM,16,-13,MEM-OKC-1,OKC,29,1,32.5
MEM,16,-13,MEM-OKC-1,OKC,29,1,32.75
MEM,16,-13,MEM-OKC-1,OKC,29,1,33.0
MEM,16,-13,MEM-OKC-1,OKC,29,1,33.25
MEM,16,-13,MEM-OKC-1,OKC,29,1,33.5
MEM,16,-13,MEM-OKC-1,OKC,29,1,33.75
MEM,16,-13,MEM-OKC-1,OKC,29,1,34.0
MEM,16,-13,MEM-OKC-1,OKC,29,1,34.25
MEM,16,-13,MEM-OKC-1,OKC,29,1,34.5
MEM,16,-13,MEM-OKC-1,OKC,29,1,34.75
MEM,16,-13,MEM-OKC-1,OKC,29,1,35.0
MEM,16,-13,MEM-OKC-1,OKC,29,1,35.25
MEM,16,-13,MEM-OKC-1,OKC,29,1,35.5
MEM,16,-13,MEM-OKC-1,OKC,29,1,35.75
MEM,16,-13,MEM-OKC-1,OKC,29,1,36.0
MEM,16,-13,MEM-OKC-1,OKC,29,1,36.25
MEM,16,-13,MEM-OKC-1,OKC,29,1,36.5
MEM,16,-13,MEM-OKC-1,OKC,29,1,36.75
MEM,16,-13,MEM-OKC-1,OKC,29,1,37.0
MEM,16,-13,MEM-OKC-1,OKC,29,1,37.25
MEM,16,-13,MEM-OKC-1,OKC,29,1,37.5
MEM,16,-13,MEM-OKC-1,OKC,29,1,37.75
MEM,16,-13,MEM-OKC-1,OKC,29,1,38.0
MEM,16,-13,MEM-OKC-1,OKC,29,1,38.25
MEM,16,-13,MEM-OKC-1,OKC,29,1,38.5
MEM,16,-13,MEM-OKC-1,OKC,29,1,38.75
MEM,16,-13,MEM-OKC-1,OKC,29,1,39.0
MEM,16,-13,MEM-OKC-1,OKC,29,1,39.25
MEM,16,-13,MEM-OKC-1,OKC,29,1,39.5
MEM,16,-13,MEM-OKC-1,OKC,29,1,39.75
MEM,16,-13,MEM-OKC-1,OKC,29,1,40.0
MEM,16,-13,MEM-OKC-1,OKC,29,1,40.25
MEM,16,-13,MEM-OKC-1,OKC,29,1,40.5
MEM,16,-13,MEM-OKC-1,OKC,29,1,40.75
MEM,16,-13,MEM-OKC-1,OKC,29,1,41.0
MEM,16,-13,MEM-OKC-1,OKC,29,1,41.25
MEM,16,-13,MEM-OKC-1,OKC,29,1,41.5
MEM,16,-13,MEM-OKC-1,OKC,29,1,41.75
MEM,16,-13,MEM-OKC-1,OKC,29,1,42.0
MEM,16,-13,MEM-OKC-1,OKC,29,1,42.25
MEM,16,-13,MEM-OKC-1,OKC,29,1,42.5
MEM,16,-13,MEM-OKC-1,OKC,29,1,42.75
MEM,16,-13,MEM-OKC-1,OKC,29,1,43.0
MEM,16,-13,MEM-OKC-1,OKC,29,1,43.25
MEM,16,-13,MEM-OKC-1,OKC,29,1,43.5
MEM,16,-13,MEM-OKC-1,OKC,29,1,43.75
MEM,16,-13,MEM-OKC-1,OKC,29,1,44.0
MEM,16,-13,MEM-OKC-1,OKC,29,1,44.25
MEM,16,-13,MEM-OKC-1,OKC,29,1,44.5
MEM,16,-13,MEM-OKC-1,OKC,29,1,44.75
MEM,16,-13,MEM-OKC-1,OKC,29,1,45.0
MEM,16,-13,MEM-OKC-1,OKC,29,1,45.25
MEM,16,-13,MEM-OKC-1,OKC,29,1,45.5
MEM,16,-13,MEM-OKC-1,OKC,29,1,45.75
MEM,16,-13,MEM-OKC-1,OKC,29,1,46.0
MEM,16,-13,MEM-OKC-1,OKC,29,1,46.25
MEM,16,-13,MEM-OKC-1,OKC,29,1,46.5
MEM,16,-13,MEM-OKC-1,OKC,29,1,46.75
MEM,16,-13,MEM-OKC-1,OKC,29,1,47.0
MEM,16,-13,MEM-OKC-1,OKC,29,1,47.25
MEM,16,-13,MEM-OKC-1,OKC,29,1,47.5
MEM,16,-13,MEM-OKC-1,OKC,29,1,47.75
MEM,16,-13,MEM-OKC-1,OKC,29,1,48.0
MEM,16,-13,MEM-OKC-1,OKC,29,1,48.25
MEM,16,-13,MEM-OKC-1,OKC,29,1,48.5
MEM,16,-13,MEM-OKC-1,OKC,29,1,48.75
DAL,0,-2,DAL-SA-1,SA,2,1,0.0
DAL,0,-2,DAL-SA-1,SA,2,1,0.25
DAL,0,-2,DAL-SA-1,SA,2,1,0.5
DAL,0,-2,DAL-SA-1,SA,2,1,0.75
DAL,0,-2,DAL-SA-1,SA,2,1,1.0
DAL,0,-2,DAL-SA-1,SA,2,1,1.25
DAL,0,-2,DAL-SA-1,SA,2,1,1.5
DAL,2,0,DAL-SA-1,SA,2,1,1.75
DAL,2,0,DAL-SA-1,SA,2,1,2.0
DAL,2,0,DAL-SA-1,SA,2,1,2.25
DAL,2,-2,DAL-SA-1,SA,4,1,2.5
DAL,2,-2,DAL-SA-1,SA,4,1,2.75
DAL,2,-5,DAL-SA-1,SA,7,1,3.0
DAL,2,-5,DAL-SA-1,SA,7,1,3.25
DAL,2,-7,DAL-SA-1,SA,9,1,3.5
DAL,2,-7,DAL-SA-1,SA,9,1,3.75
DAL,2,-7,DAL-SA-1,SA,9,1,4.0
DAL,2,-7,DAL-SA-1,SA,9,1,4.25
DAL,2,-7,DAL-SA-1,SA,9,1,4.5
DAL,2,-7,DAL-SA-1,SA,9,1,4.75
DAL,2,-7,DAL-SA-1,SA,9,1,5.0
DAL,4,-5,DAL-SA-1,SA,9,1,5.25
DAL,5,-4,DAL-SA-1,SA,9,1,5.5
DAL,5,-4,DAL-SA-1,SA,9,1,5.75
DAL,5,-6,DAL-SA-1,SA,11,1,6.0
DAL,5,-6,DAL-SA-1,SA,11,1,6.25
DAL,5,-6,DAL-SA-1,SA,11,1,6.5
DAL,5,-8,DAL-SA-1,SA,13,1,6.75
DAL,5,-8,DAL-SA-1,SA,13,1,7.0
DAL,5,-8,DAL-SA-1,SA,13,1,7.25
DAL,5,-8,DAL-SA-1,SA,13,1,7.5
DAL,5,-8,DAL-SA-1,SA,13,1,7.75
DAL,7,-6,DAL-SA-1,SA,13,1,8.0
DAL,7,-8,DAL-SA-1,SA,15,1,8.25
DAL,7,-8,DAL-SA-1,SA,15,1,8.5
DAL,7,-8,DAL-SA-1,SA,15,1,8.75
DAL,7,-10,DAL-SA-1,SA,17,1,9.0
DAL,7,-10,DAL-SA-1,SA,17,1,9.25
DAL,9,-8,DAL-SA-1,SA,17,1,9.5
DAL,9,-8,DAL-SA-1,SA,17,1,9.75
DAL,9,-8,DAL-SA-1,SA,17,1,10.0
DAL,9,-10,DAL-SA-1,SA,19,1,10.25
DAL,9,-12,DAL-SA-1,SA,21,1,10.5
DAL,9,-12,DAL-SA-1,SA,21,1,10.75
DAL,9,-12,DAL-SA-1,SA,21,1,11.0
DAL,12,-9,DAL-SA-1,SA,21,1,11.25
DAL,12,-9,DAL-SA-1,SA,21,1,11.5
DAL,12,-9,DAL-SA-1,SA,21,1,11.75
DAL,12,-9,DAL-SA-1,SA,21,1,12.0
DAL,12,-9,DAL-SA-1,SA,21,1,12.25
DAL,12,-9,DAL-SA-1,SA,21,1,12.5
DAL,12,-9,DAL-SA-1,SA,21,1,12.75
DAL,12,-9,DAL-SA-1,SA,21,1,13.0
DAL,12,-9,DAL-SA-1,SA,21,1,13.25
DAL,12,-9,DAL-SA-1,SA,21,1,13.5
DAL,12,-9,DAL-SA-1,SA,21,1,13.75
DAL,12,-9,DAL-SA-1,SA,21,1,14.0
DAL,12,-9,DAL-SA-1,SA,21,1,14.25
DAL,12,-9,DAL-SA-1,SA,21,1,14.5
DAL,12,-9,DAL-SA-1,SA,21,1,14.75
DAL,12,-9,DAL-SA-1,SA,21,1,15.0
DAL,12,-9,DAL-SA-1,SA,21,1,15.25
DAL,12,-9,DAL-SA-1,SA,21,1,15.5
DAL,12,-9,DAL-SA-1,SA,21,1,15.75
DAL,12,-9,DAL-SA-1,SA,21,1,16.0
DAL,12,-9,DAL-SA-1,SA,21,1,16.25
DAL,12,-9,DAL-SA-1,SA,21,1,16.5
DAL,12,-9,DAL-SA-1,SA,21,1,16.75
DAL,12,-9,DAL-SA-1,SA,21,1,17.0
DAL,12,-9,DAL-SA-1,SA,21,1,17.25
DAL,12,-9,DAL-SA-1,SA,21,1,17.5
DAL,12,-9,DAL-SA-1,SA,21,1,17.75
DAL,12,-9,DAL-SA-1,SA,21,1,18.0
DAL,12,-9,DAL-SA-1,SA,21,1,18.25
DAL,12,-9,DAL-SA-1,SA,21,1,18.5
DAL,12,-9,DAL-SA-1,SA,21,1,18.75
DAL,12,-9,DAL-SA-1,SA,21,1,19.0
DAL,12,-9,DAL-SA-1,SA,21,1,19.25
DAL,12,-9,DAL-SA-1,SA,21,1,19.5
DAL,12,-9,DAL-SA-1,SA,21,1,19.75
DAL,12,-9,DAL-SA-1,SA,21,1,20.0
DAL,12,-9,DAL-SA-1,SA,21,1,20.25
DAL,12,-9,DAL-SA-1,SA,21,1,20.5
DAL,12,-9,DAL-SA-1,SA,21,1,20.75
DAL,12,-9,DAL-SA-1,SA,21,1,21.0
DAL,12,-9,DAL-SA-1,SA,21,1,21.25
DAL,12,-9,DAL-SA-1,SA,21,1,21.5
DAL,12,-9,DAL-SA-1,SA,21,1,21.75
DAL,12,-9,DAL-SA-1,SA,21,1,22.0
DAL,12,-9,DAL-SA-1,SA,21,1,22.25
DAL,12,-9,DAL-SA-1,SA,21,1,22.5
DAL,12,-9,DAL-SA-1,SA,21,1,22.75
DAL,12,-9,DAL-SA-1,SA,21,1,23.0
DAL,12,-9,DAL-SA-1,SA,21,1,23.25
DAL,12,-9,DAL-SA-1,SA,21,1,23.5
DAL,12,-9,DAL-SA-1,SA,21,1,23.75
DAL,12,-9,DAL-SA-1,SA,21,1,24.0
DAL,12,-9,DAL-SA-1,SA,21,1,24.25
DAL,12,-9,DAL-SA-1,SA,21,1,24.5
DAL,12,-9,DAL-SA-1,SA,21,1,24.75
DAL,12,-9,DAL-SA-1,SA,21,1,25.0
DAL,12,-9,DAL-SA-1,SA,21,1,25.25
DAL,12,-9,DAL-SA-1,SA,21,1,25.5
DAL,12,-9,DAL-SA-1,SA,21,1,25.75
DAL,12,-9,DAL-SA-1,SA,21,1,26.0
DAL,12,-9,DAL-SA-1,SA,21,1,26.25
DAL,12,-9,DAL-SA-1,SA,21,1,26.5
DAL,12,-9,DAL-SA-1,SA,21,1,26.75
DAL,12,-9,DAL-SA-1,SA,21,1,27.0
DAL,12,-9,DAL-SA-1,SA,21,1,27.25
DAL,12,-9,DAL-SA-1,SA,21,1,27.5
DAL,12,-9,DAL-SA-1,SA,21,1,27.75
DAL,12,-9,DAL-SA-1,SA,21,1,28.0
DAL,12,-9,DAL-SA-1,SA,21,1,28.25
DAL,12,-9,DAL-SA-1,SA,21,1,28.5
DAL,12,-9,DAL-SA-1,SA,21,1,28.75
DAL,12,-9,DAL-SA-1,SA,21,1,29.0
DAL,12,-9,DAL-SA-1,SA,21,1,29.25
DAL,12,-9,DAL-SA-1,SA,21,1,29.5
DAL,12,-9,DAL-SA-1,SA,21,1,29.75
DAL,12,-9,DAL-SA-1,SA,21,1,30.0
DAL,12,-9,DAL-SA-1,SA,21,1,30.25
DAL,12,-9,DAL-SA-1,SA,21,1,30.5
DAL,12,-9,DAL-SA-1,SA,21,1,30.75
DAL,12,-9,DAL-SA-1,SA,21,1,31.0
DAL,12,-9,DAL-SA-1,SA,21,1,31.25
DAL,12,-9,DAL-SA-1,SA,21,1,31.5
DAL,12,-9,DAL-SA-1,SA,21,1,31.75
DAL,12,-9,DAL-SA-1,SA,21,1,32.0
DAL,12,-9,DAL-SA-1,SA,21,1,32.25
DAL,12,-9,DAL-SA-1,SA,21,1,32.5
DAL,12,-9,DAL-SA-1,SA,21,1,32.75
DAL,12,-9,DAL-SA-1,SA,21,1,33.0
DAL,12,-9,DAL-SA-1,SA,21,1,33.25
DAL,12,-9,DAL-SA-1,SA,21,1,33.5
DAL,12,-9,DAL-SA-1,SA,21,1,33.75
DAL,12,-9,DAL-SA-1,SA,21,1,34.0
DAL,12,-9,DAL-SA-1,SA,21,1,34.25
DAL,12,-9,DAL-SA-1,SA,21,1,34.5
DAL,12,-9,DAL-SA-1,SA,21,1,34.75
DAL,12,-9,DAL-SA-1,SA,21,1,35.0
DAL,12,-9,DAL-SA-1,SA,21,1,35.25
DAL,12,-9,DAL-SA-1,SA,21,1,35.5
DAL,12,-9,DAL-SA-1,SA,21,1,35.75
DAL,12,-9,DAL-SA-1,SA,21,1,36.0
DAL,12,-9,DAL-SA-1,SA,21,1,36.25
DAL,12,-9,DAL-SA-1,SA,21,1,36.5
DAL,12,-9,DAL-SA-1,SA,21,1,36.75
DAL,12,-9,DAL-SA-1,SA,21,1,37.0
DAL,12,-9,DAL-SA-1,SA,21,1,37.25
DAL,12,-9,DAL-SA-1,SA,21,1,37.5
DAL,12,-9,DAL-SA-1,SA,21,1,37.75
DAL,12,-9,DAL-SA-1,SA,21,1,38.0
DAL,12,-9,DAL-SA-1,SA,21,1,38.25
DAL,12,-9,DAL-SA-1,SA,21,1,38.5
DAL,12,-9,DAL-SA-1,SA,21,1,38.75
DAL,12,-9,DAL-SA-1,SA,21,1,39.0
DAL,12,-9,DAL-SA-1,SA,21,1,39.25
DAL,12,-9,DAL-SA-1,SA,21,1,39.5
DAL,12,-9,DAL-SA-1,SA,21,1,39.75
DAL,12,-9,DAL-SA-1,SA,21,1,40.0
DAL,12,-9,DAL-SA-1,SA,21,1,40.25
DAL,12,-9,DAL-SA-1,SA,21,1,40.5
DAL,12,-9,DAL-SA-1,SA,21,1,40.75
DAL,12,-9,DAL-SA-1,SA,21,1,41.0
DAL,12,-9,DAL-SA-1,SA,21,1,41.25
DAL,12,-9,DAL-SA-1,SA,21,1,41.5
DAL,12,-9,DAL-SA-1,SA,21,1,41.75
DAL,12,-9,DAL-SA-1,SA,21,1,42.0
DAL,12,-9,DAL-SA-1,SA,21,1,42.25
DAL,12,-9,DAL-SA-1,SA,21,1,42.5
DAL,12,-9,DAL-SA-1,SA,21,1,42.75
DAL,12,-9,DAL-SA-1,SA,21,1,43.0
DAL,12,-9,DAL-SA-1,SA,21,1,43.25
DAL,12,-9,DAL-SA-1,SA,21,1,43.5
DAL,12,-9,DAL-SA-1,SA,21,1,43.75
DAL,12,-9,DAL-SA-1,SA,21,1,44.0
DAL,12,-9,DAL-SA-1,SA,21,1,44.25
DAL,12,-9,DAL-SA-1,SA,21,1,44.5
DAL,12,-9,DAL-SA-1,SA,21,1,44.75
DAL,12,-9,DAL-SA-1,SA,21,1,45.0
DAL,12,-9,DAL-SA-1,SA,21,1,45.25
DAL,12,-9,DAL-SA-1,SA,21,1,45.5
DAL,12,-9,DAL-SA-1,SA,21,1,45.75
DAL,12,-9,DAL-SA-1,SA,21,1,46.0
DAL,12,-9,DAL-SA-1,SA,21,1,46.25
DAL,12,-9,DAL-SA-1,SA,21,1,46.5
DAL,12,-9,DAL-SA-1,SA,21,1,46.75
DAL,12,-9,DAL-SA-1,SA,21,1,47.0
DAL,12,-9,DAL-SA-1,SA,21,1,47.25
DAL,12,-9,DAL-SA-1,SA,21,1,47.5
DAL,12,-9,DAL-SA-1,SA,21,1,47.75
DAL,12,-9,DAL-SA-1,SA,21,1,48.0
DAL,12,-9,DAL-SA-1,SA,21,1,48.25
DAL,12,-9,DAL-SA-1,SA,21,1,48.5
DAL,12,-9,DAL-SA-1,SA,21,1,48.75
CHA,2,2,CHA-MIA-1,MIA,0,1,0.0
CHA,4,4,CHA-MIA-1,MIA,0,1,0.25
CHA,4,4,CHA-MIA-1,MIA,0,1,0.5
CHA,4,4,CHA-MIA-1,MIA,0,1,0.75
CHA,4,2,CHA-MIA-1,MIA,2,1,1.0
CHA,6,4,CHA-MIA-1,MIA,2,1,1.25
CHA,6,1,CHA-MIA-1,MIA,5,1,1.5
CHA,6,1,CHA-MIA-1,MIA,5,1,1.75
CHA,6,1,CHA-MIA-1,MIA,5,1,2.0
CHA,6,1,CHA-MIA-1,MIA,5,1,2.25
CHA,6,1,CHA-MIA-1,MIA,5,1,2.5
CHA,6,1,CHA-MIA-1,MIA,5,1,2.75
CHA,6,1,CHA-MIA-1,MIA,5,1,3.0
CHA,6,-1,CHA-MIA-1,MIA,7,1,3.25
CHA,6,-1,CHA-MIA-1,MIA,7,1,3.5
CHA,8,1,CHA-MIA-1,MIA,7,1,3.75
CHA,10,3,CHA-MIA-1,MIA,7,1,4.0
CHA,10,3,CHA-MIA-1,MIA,7,1,4.25
CHA,12,5,CHA-MIA-1,MIA,7,1,4.5
CHA,12,5,CHA-MIA-1,MIA,7,1,4.75
CHA,14,7,CHA-MIA-1,MIA,7,1,5.0
CHA,14,7,CHA-MIA-1,MIA,7,1,5.25
CHA,14,5,CHA-MIA-1,MIA,9,1,5.5
CHA,14,5,CHA-MIA-1,MIA,9,1,5.75
CHA,16,5,CHA-MIA-1,MIA,11,1,6.0
CHA,16,5,CHA-MIA-1,MIA,11,1,6.25
CHA,16,5,CHA-MIA-1,MIA,11,1,6.5
CHA,16,5,CHA-MIA-1,MIA,11,1,6.75
CHA,17,6,CHA-MIA-1,MIA,11,1,7.0
CHA,17,6,CHA-MIA-1,MIA,11,1,7.25
CHA,17,6,CHA-MIA-1,MIA,11,1,7.5
CHA,19,8,CHA-MIA-1,MIA,11,1,7.75
CHA,19,8,CHA-MIA-1,MIA,11,1,8.0
CHA,19,8,CHA-MIA-1,MIA,11,1,8.25
CHA,19,7,CHA-MIA-1,MIA,12,1,8.5
CHA,19,7,CHA-MIA-1,MIA,12,1,8.75
CHA,21,9,CHA-MIA-1,MIA,12,1,9.0
CHA,21,7,CHA-MIA-1,MIA,14,1,9.25
CHA,21,7,CHA-MIA-1,MIA,14,1,9.5
CHA,21,7,CHA-MIA-1,MIA,14,1,9.75
CHA,21,6,CHA-MIA-1,MIA,15,1,10.0
CHA,21,6,CHA-MIA-1,MIA,15,1,10.25
CHA,23,7,CHA-MIA-1,MIA,16,1,10.5
CHA,23,7,CHA-MIA-1,MIA,16,1,10.75
CHA,23,7,CHA-MIA-1,MIA,16,1,11.0
CHA,23,5,CHA-MIA-1,MIA,18,1,11.25
CHA,23,4,CHA-MIA-1,MIA,19,1,11.5
CHA,23,4,CHA-MIA-1,MIA,19,1,11.75
CHA,23,4,CHA-MIA-1,MIA,19,1,12.0
CHA,23,4,CHA-MIA-1,MIA,19,1,12.25
CHA,23,4,CHA-MIA-1,MIA,19,1,12.5
CHA,23,4,CHA-MIA-1,MIA,19,1,12.75
CHA,23,4,CHA-MIA-1,MIA,19,1,13.0
CHA,23,4,CHA-MIA-1,MIA,19,1,13.25
CHA,23,4,CHA-MIA-1,MIA,19,1,13.5
CHA,23,4,CHA-MIA-1,MIA,19,1,13.75
CHA,23,4,CHA-MIA-1,MIA,19,1,14.0
CHA,23,4,CHA-MIA-1,MIA,19,1,14.25
CHA,23,4,CHA-MIA-1,MIA,19,1,14.5
CHA,23,4,CHA-MIA-1,MIA,19,1,14.75
CHA,23,4,CHA-MIA-1,MIA,19,1,15.0
CHA,23,4,CHA-MIA-1,MIA,19,1,15.25
CHA,23,4,CHA-MIA-1,MIA,19,1,15.5
CHA,23,4,CHA-MIA-1,MIA,19,1,15.75
CHA,23,4,CHA-MIA-1,MIA,19,1,16.0
CHA,23,4,CHA-MIA-1,MIA,19,1,16.25
CHA,23,4,CHA-MIA-1,MIA,19,1,16.5
CHA,23,4,CHA-MIA-1,MIA,19,1,16.75
CHA,23,4,CHA-MIA-1,MIA,19,1,17.0
CHA,23,4,CHA-MIA-1,MIA,19,1,17.25
CHA,23,4,CHA-MIA-1,MIA,19,1,17.5
CHA,23,4,CHA-MIA-1,MIA,19,1,17.75
CHA,23,4,CHA-MIA-1,MIA,19,1,18.0
CHA,23,4,CHA-MIA-1,MIA,19,1,18.25
CHA,23,4,CHA-MIA-1,MIA,19,1,18.5
CHA,23,4,CHA-MIA-1,MIA,19,1,18.75
CHA,23,4,CHA-MIA-1,MIA,19,1,19.0
CHA,23,4,CHA-MIA-1,MIA,19,1,19.25
CHA,23,4,CHA-MIA-1,MIA,19,1,19.5
CHA,23,4,CHA-MIA-1,MIA,19,1,19.75
CHA,23,4,CHA-MIA-1,MIA,19,1,20.0
CHA,23,4,CHA-MIA-1,MIA,19,1,20.25
CHA,23,4,CHA-MIA-1,MIA,19,1,20.5
CHA,23,4,CHA-MIA-1,MIA,19,1,20.75
CHA,23,4,CHA-MIA-1,MIA,19,1,21.0
CHA,23,4,CHA-MIA-1,MIA,19,1,21.25
CHA,23,4,CHA-MIA-1,MIA,19,1,21.5
CHA,23,4,CHA-MIA-1,MIA,19,1,21.75
CHA,23,4,CHA-MIA-1,MIA,19,1,22.0
CHA,23,4,CHA-MIA-1,MIA,19,1,22.25
CHA,23,4,CHA-MIA-1,MIA,19,1,22.5
CHA,23,4,CHA-MIA-1,MIA,19,1,22.75
CHA,23,4,CHA-MIA-1,MIA,19,1,23.0
CHA,23,4,CHA-MIA-1,MIA,19,1,23.25
CHA,23,4,CHA-MIA-1,MIA,19,1,23.5
CHA,23,4,CHA-MIA-1,MIA,19,1,23.75
CHA,23,4,CHA-MIA-1,MIA,19,1,24.0
CHA,23,4,CHA-MIA-1,MIA,19,1,24.25
CHA,23,4,CHA-MIA-1,MIA,19,1,24.5
CHA,23,4,CHA-MIA-1,MIA,19,1,24.75
CHA,23,4,CHA-MIA-1,MIA,19,1,25.0
CHA,23,4,CHA-MIA-1,MIA,19,1,25.25
CHA,23,4,CHA-MIA-1,MIA,19,1,25.5
CHA,23,4,CHA-MIA-1,MIA,19,1,25.75
CHA,23,4,CHA-MIA-1,MIA,19,1,26.0
CHA,23,4,CHA-MIA-1,MIA,19,1,26.25
CHA,23,4,CHA-MIA-1,MIA,19,1,26.5
CHA,23,4,CHA-MIA-1,MIA,19,1,26.75
CHA,23,4,CHA-MIA-1,MIA,19,1,27.0
CHA,23,4,CHA-MIA-1,MIA,19,1,27.25
CHA,23,4,CHA-MIA-1,MIA,19,1,27.5
CHA,23,4,CHA-MIA-1,MIA,19,1,27.75
CHA,23,4,CHA-MIA-1,MIA,19,1,28.0
CHA,23,4,CHA-MIA-1,MIA,19,1,28.25
CHA,23,4,CHA-MIA-1,MIA,19,1,28.5
CHA,23,4,CHA-MIA-1,MIA,19,1,28.75
CHA,23,4,CHA-MIA-1,MIA,19,1,29.0
CHA,23,4,CHA-MIA-1,MIA,19,1,29.25
CHA,23,4,CHA-MIA-1,MIA,19,1,29.5
CHA,23,4,CHA-MIA-1,MIA,19,1,29.75
CHA,23,4,CHA-MIA-1,MIA,19,1,30.0
CHA,23,4,CHA-MIA-1,MIA,19,1,30.25
CHA,23,4,CHA-MIA-1,MIA,19,1,30.5
CHA,23,4,CHA-MIA-1,MIA,19,1,30.75
CHA,23,4,CHA-MIA-1,MIA,19,1,31.0
CHA,23,4,CHA-MIA-1,MIA,19,1,31.25
CHA,23,4,CHA-MIA-1,MIA,19,1,31.5
CHA,23,4,CHA-MIA-1,MIA,19,1,31.75
CHA,23,4,CHA-MIA-1,MIA,19,1,32.0
CHA,23,4,CHA-MIA-1,MIA,19,1,32.25
CHA,23,4,CHA-MIA-1,MIA,19,1,32.5
CHA,23,4,CHA-MIA-1,MIA,19,1,32.75
CHA,23,4,CHA-MIA-1,MIA,19,1,33.0
CHA,23,4,CHA-MIA-1,MIA,19,1,33.25
CHA,23,4,CHA-MIA-1,MIA,19,1,33.5
CHA,23,4,CHA-MIA-1,MIA,19,1,33.75
CHA,23,4,CHA-MIA-1,MIA,19,1,34.0
CHA,23,4,CHA-MIA-1,MIA,19,1,34.25
CHA,23,4,CHA-MIA-1,MIA,19,1,34.5
CHA,23,4,CHA-MIA-1,MIA,19,1,34.75
CHA,23,4,CHA-MIA-1,MIA,19,1,35.0
CHA,23,4,CHA-MIA-1,MIA,19,1,35.25
CHA,23,4,CHA-MIA-1,MIA,19,1,35.5
CHA,23,4,CHA-MIA-1,MIA,19,1,35.75
CHA,23,4,CHA-MIA-1,MIA,19,1,36.0
CHA,23,4,CHA-MIA-1,MIA,19,1,36.25
CHA,23,4,CHA-MIA-1,MIA,19,1,36.5
CHA,23,4,CHA-MIA-1,MIA,19,1,36.75
CHA,23,4,CHA-MIA-1,MIA,19,1,37.0
CHA,23,4,CHA-MIA-1,MIA,19,1,37.25
CHA,23,4,CHA-MIA-1,MIA,19,1,37.5
CHA,23,4,CHA-MIA-1,MIA,19,1,37.75
CHA,23,4,CHA-MIA-1,MIA,19,1,38.0
CHA,23,4,CHA-MIA-1,MIA,19,1,38.25
CHA,23,4,CHA-MIA-1,MIA,19,1,38.5
CHA,23,4,CHA-MIA-1,MIA,19,1,38.75
CHA,23,4,CHA-MIA-1,MIA,19,1,39.0
CHA,23,4,CHA-MIA-1,MIA,19,1,39.25
CHA,23,4,CHA-MIA-1,MIA,19,1,39.5
CHA,23,4,CHA-MIA-1,MIA,19,1,39.75
CHA,23,4,CHA-MIA-1,MIA,19,1,40.0
CHA,23,4,CHA-MIA-1,MIA,19,1,40.25
CHA,23,4,CHA-MIA-1,MIA,19,1,40.5
CHA,23,4,CHA-MIA-1,MIA,19,1,40.75
CHA,23,4,CHA-MIA-1,MIA,19,1,41.0
CHA,23,4,CHA-MIA-1,MIA,19,1,41.25
CHA,23,4,CHA-MIA-1,MIA,19,1,41.5
CHA,23,4,CHA-MIA-1,MIA,19,1,41.75
CHA,23,4,CHA-MIA-1,MIA,19,1,42.0
CHA,23,4,CHA-MIA-1,MIA,19,1,42.25
CHA,23,4,CHA-MIA-1,MIA,19,1,42.5
CHA,23,4,CHA-MIA-1,MIA,19,1,42.75
CHA,23,4,CHA-MIA-1,MIA,19,1,43.0
CHA,23,4,CHA-MIA-1,MIA,19,1,43.25
CHA,23,4,CHA-MIA-1,MIA,19,1,43.5
CHA,23,4,CHA-MIA-1,MIA,19,1,43.75
CHA,23,4,CHA-MIA-1,MIA,19,1,44.0
CHA,23,4,CHA-MIA-1,MIA,19,1,44.25
CHA,23,4,CHA-MIA-1,MIA,19,1,44.5
CHA,23,4,CHA-MIA-1,MIA,19,1,44.75
CHA,23,4,CHA-MIA-1,MIA,19,1,45.0
CHA,23,4,CHA-MIA-1,MIA,19,1,45.25
CHA,23,4,CHA-MIA-1,MIA,19,1,45.5
CHA,23,4,CHA-MIA-1,MIA,19,1,45.75
CHA,23,4,CHA-MIA-1,MIA,19,1,46.0
CHA,23,4,CHA-MIA-1,MIA,19,1,46.25
CHA,23,4,CHA-MIA-1,MIA,19,1,46.5
CHA,23,4,CHA-MIA-1,MIA,19,1,46.75
CHA,23,4,CHA-MIA-1,MIA,19,1,47.0
CHA,23,4,CHA-MIA-1,MIA,19,1,47.25
CHA,23,4,CHA-MIA-1,MIA,19,1,47.5
CHA,23,4,CHA-MIA-1,MIA,19,1,47.75
CHA,23,4,CHA-MIA-1,MIA,19,1,48.0
CHA,23,4,CHA-MIA-1,MIA,19,1,48.25
CHA,23,4,CHA-MIA-1,MIA,19,1,48.5
CHA,23,4,CHA-MIA-1,MIA,19,1,48.75
WSH,2,2,WSH-CHI-1,CHI,0,1,0.0
WSH,2,2,WSH-CHI-1,CHI,0,1,0.25
WSH,4,4,WSH-CHI-1,CHI,0,1,0.5
WSH,4,4,WSH-CHI-1,CHI,0,1,0.75
WSH,4,4,WSH-CHI-1,CHI,0,1,1.0
WSH,4,4,WSH-CHI-1,CHI,0,1,1.25
WSH,4,2,WSH-CHI-1,CHI,2,1,1.5
WSH,6,4,WSH-CHI-1,CHI,2,1,1.75
WSH,6,4,WSH-CHI-1,CHI,2,1,2.0
WSH,6,2,WSH-CHI-1,CHI,4,1,2.25
WSH,7,3,WSH-CHI-1,CHI,4,1,2.5
WSH,8,2,WSH-CHI-1,CHI,6,1,2.75
WSH,8,0,WSH-CHI-1,CHI,8,1,3.0
WSH,8,0,WSH-CHI-1,CHI,8,1,3.25
WSH,8,0,WSH-CHI-1,CHI,8,1,3.5
WSH,8,0,WSH-CHI-1,CHI,8,1,3.75
WSH,8,0,WSH-CHI-1,CHI,8,1,4.0
WSH,8,0,WSH-CHI-1,CHI,8,1,4.25
WSH,10,2,WSH-CHI-1,CHI,8,1,4.5
WSH,10,2,WSH-CHI-1,CHI,8,1,4.75
WSH,10,2,WSH-CHI-1,CHI,8,1,5.0
WSH,10,2,WSH-CHI-1,CHI,8,1,5.25
WSH,12,4,WSH-CHI-1,CHI,8,1,5.5
WSH,12,4,WSH-CHI-1,CHI,8,1,5.75
WSH,12,1,WSH-CHI-1,CHI,11,1,6.0
WSH,12,1,WSH-CHI-1,CHI,11,1,6.25
WSH,12,1,WSH-CHI-1,CHI,11,1,6.5
WSH,14,3,WSH-CHI-1,CHI,11,1,6.75
WSH,14,3,WSH-CHI-1,CHI,11,1,7.0
WSH,16,5,WSH-CHI-1,CHI,11,1,7.25
WSH,16,3,WSH-CHI-1,CHI,13,1,7.5
WSH,16,3,WSH-CHI-1,CHI,13,1,7.75
WSH,17,4,WSH-CHI-1,CHI,13,1,8.0
WSH,17,4,WSH-CHI-1,CHI,13,1,8.25
WSH,19,6,WSH-CHI-1,CHI,13,1,8.5
WSH,19,6,WSH-CHI-1,CHI,13,1,8.75
WSH,19,4,WSH-CHI-1,CHI,15,1,9.0
WSH,21,6,WSH-CHI-1,CHI,15,1,9.25
WSH,21,6,WSH-CHI-1,CHI,15,1,9.5
WSH,21,4,WSH-CHI-1,CHI,17,1,9.75
WSH,22,5,WSH-CHI-1,CHI,17,1,10.0
WSH,22,5,WSH-CHI-1,CHI,17,1,10.25
WSH,22,5,WSH-CHI-1,CHI,17,1,10.5
WSH,22,3,WSH-CHI-1,CHI,19,1,10.75
WSH,24,5,WSH-CHI-1,CHI,19,1,11.0
WSH,24,5,WSH-CHI-1,CHI,19,1,11.25
WSH,24,3,WSH-CHI-1,CHI,21,1,11.5
WSH,24,2,WSH-CHI-1,CHI,22,1,11.75
WSH,24,2,WSH-CHI-1,CHI,22,1,12.0
WSH,24,2,WSH-CHI-1,CHI,22,1,12.25
WSH,24,2,WSH-CHI-1,CHI,22,1,12.5
WSH,24,2,WSH-CHI-1,CHI,22,1,12.75
WSH,24,2,WSH-CHI-1,CHI,22,1,13.0
WSH,24,2,WSH-CHI-1,CHI,22,1,13.25
WSH,24,2,WSH-CHI-1,CHI,22,1,13.5
WSH,24,2,WSH-CHI-1,CHI,22,1,13.75
WSH,24,2,WSH-CHI-1,CHI,22,1,14.0
WSH,24,2,WSH-CHI-1,CHI,22,1,14.25
WSH,24,2,WSH-CHI-1,CHI,22,1,14.5
WSH,24,2,WSH-CHI-1,CHI,22,1,14.75
WSH,24,2,WSH-CHI-1,CHI,22,1,15.0
WSH,24,2,WSH-CHI-1,CHI,22,1,15.25
WSH,24,2,WSH-CHI-1,CHI,22,1,15.5
WSH,24,2,WSH-CHI-1,CHI,22,1,15.75
WSH,24,2,WSH-CHI-1,CHI,22,1,16.0
WSH,24,2,WSH-CHI-1,CHI,22,1,16.25
WSH,24,2,WSH-CHI-1,CHI,22,1,16.5
WSH,24,2,WSH-CHI-1,CHI,22,1,16.75
WSH,24,2,WSH-CHI-1,CHI,22,1,17.0
WSH,24,2,WSH-CHI-1,CHI,22,1,17.25
WSH,24,2,WSH-CHI-1,CHI,22,1,17.5
WSH,24,2,WSH-CHI-1,CHI,22,1,17.75
WSH,24,2,WSH-CHI-1,CHI,22,1,18.0
WSH,24,2,WSH-CHI-1,CHI,22,1,18.25
WSH,24,2,WSH-CHI-1,CHI,22,1,18.5
WSH,24,2,WSH-CHI-1,CHI,22,1,18.75
WSH,24,2,WSH-CHI-1,CHI,22,1,19.0
WSH,24,2,WSH-CHI-1,CHI,22,1,19.25
WSH,24,2,WSH-CHI-1,CHI,22,1,19.5
WSH,24,2,WSH-CHI-1,CHI,22,1,19.75
WSH,24,2,WSH-CHI-1,CHI,22,1,20.0
WSH,24,2,WSH-CHI-1,CHI,22,1,20.25
WSH,24,2,WSH-CHI-1,CHI,22,1,20.5
WSH,24,2,WSH-CHI-1,CHI,22,1,20.75
WSH,24,2,WSH-CHI-1,CHI,22,1,21.0
WSH,24,2,WSH-CHI-1,CHI,22,1,21.25
WSH,24,2,WSH-CHI-1,CHI,22,1,21.5
WSH,24,2,WSH-CHI-1,CHI,22,1,21.75
WSH,24,2,WSH-CHI-1,CHI,22,1,22.0
WSH,24,2,WSH-CHI-1,CHI,22,1,22.25
WSH,24,2,WSH-CHI-1,CHI,22,1,22.5
WSH,24,2,WSH-CHI-1,CHI,22,1,22.75
WSH,24,2,WSH-CHI-1,CHI,22,1,23.0
WSH,24,2,WSH-CHI-1,CHI,22,1,23.25
WSH,24,2,WSH-CHI-1,CHI,22,1,23.5
WSH,24,2,WSH-CHI-1,CHI,22,1,23.75
WSH,24,2,WSH-CHI-1,CHI,22,1,24.0
WSH,24,2,WSH-CHI-1,CHI,22,1,24.25
WSH,24,2,WSH-CHI-1,CHI,22,1,24.5
WSH,24,2,WSH-CHI-1,CHI,22,1,24.75
WSH,24,2,WSH-CHI-1,CHI,22,1,25.0
WSH,24,2,WSH-CHI-1,CHI,22,1,25.25
WSH,24,2,WSH-CHI-1,CHI,22,1,25.5
WSH,24,2,WSH-CHI-1,CHI,22,1,25.75
WSH,24,2,WSH-CHI-1,CHI,22,1,26.0
WSH,24,2,WSH-CHI-1,CHI,22,1,26.25
WSH,24,2,WSH-CHI-1,CHI,22,1,26.5
WSH,24,2,WSH-CHI-1,CHI,22,1,26.75
WSH,24,2,WSH-CHI-1,CHI,22,1,27.0
WSH,24,2,WSH-CHI-1,CHI,22,1,27.25
WSH,24,2,WSH-CHI-1,CHI,22,1,27.5
WSH,24,2,WSH-CHI-1,CHI,22,1,27.75
WSH,24,2,WSH-CHI-1,CHI,22,1,28.0
WSH,24,2,WSH-CHI-1,CHI,22,1,28.25
WSH,24,2,WSH-CHI-1,CHI,22,1,28.5
WSH,24,2,WSH-CHI-1,CHI,22,1,28.75
WSH,24,2,WSH-CHI-1,CHI,22,1,29.0
WSH,24,2,WSH-CHI-1,CHI,22,1,29.25
WSH,24,2,WSH-CHI-1,CHI,22,1,29.5
WSH,24,2,WSH-CHI-1,CHI,22,1,29.75
WSH,24,2,WSH-CHI-1,CHI,22,1,30.0
WSH,24,2,WSH-CHI-1,CHI,22,1,30.25
WSH,24,2,WSH-CHI-1,CHI,22,1,30.5
WSH,24,2,WSH-CHI-1,CHI,22,1,30.75
WSH,24,2,WSH-CHI-1,CHI,22,1,31.0
WSH,24,2,WSH-CHI-1,CHI,22,1,31.25
WSH,24,2,WSH-CHI-1,CHI,22,1,31.5
WSH,24,2,WSH-CHI-1,CHI,22,1,31.75
WSH,24,2,WSH-CHI-1,CHI,22,1,32.0
WSH,24,2,WSH-CHI-1,CHI,22,1,32.25
WSH,24,2,WSH-CHI-1,CHI,22,1,32.5
WSH,24,2,WSH-CHI-1,CHI,22,1,32.75
WSH,24,2,WSH-CHI-1,CHI,22,1,33.0
WSH,24,2,WSH-CHI-1,CHI,22,1,33.25
WSH,24,2,WSH-CHI-1,CHI,22,1,33.5
WSH,24,2,WSH-CHI-1,CHI,22,1,33.75
WSH,24,2,WSH-CHI-1,CHI,22,1,34.0
WSH,24,2,WSH-CHI-1,CHI,22,1,34.25
WSH,24,2,WSH-CHI-1,CHI,22,1,34.5
WSH,24,2,WSH-CHI-1,CHI,22,1,34.75
WSH,24,2,WSH-CHI-1,CHI,22,1,35.0
WSH,24,2,WSH-CHI-1,CHI,22,1,35.25
WSH,24,2,WSH-CHI-1,CHI,22,1,35.5
WSH,24,2,WSH-CHI-1,CHI,22,1,35.75
WSH,24,2,WSH-CHI-1,CHI,22,1,36.0
WSH,24,2,WSH-CHI-1,CHI,22,1,36.25
WSH,24,2,WSH-CHI-1,CHI,22,1,36.5
WSH,24,2,WSH-CHI-1,CHI,22,1,36.75
WSH,24,2,WSH-CHI-1,CHI,22,1,37.0
WSH,24,2,WSH-CHI-1,CHI,22,1,37.25
WSH,24,2,WSH-CHI-1,CHI,22,1,37.5
WSH,24,2,WSH-CHI-1,CHI,22,1,37.75
WSH,24,2,WSH-CHI-1,CHI,22,1,38.0
WSH,24,2,WSH-CHI-1,CHI,22,1,38.25
WSH,24,2,WSH-CHI-1,CHI,22,1,38.5
WSH,24,2,WSH-CHI-1,CHI,22,1,38.75
WSH,24,2,WSH-CHI-1,CHI,22,1,39.0
WSH,24,2,WSH-CHI-1,CHI,22,1,39.25
WSH,24,2,WSH-CHI-1,CHI,22,1,39.5
WSH,24,2,WSH-CHI-1,CHI,22,1,39.75
WSH,24,2,WSH-CHI-1,CHI,22,1,40.0
WSH,24,2,WSH-CHI-1,CHI,22,1,40.25
WSH,24,2,WSH-CHI-1,CHI,22,1,40.5
WSH,24,2,WSH-CHI-1,CHI,22,1,40.75
WSH,24,2,WSH-CHI-1,CHI,22,1,41.0
WSH,24,2,WSH-CHI-1,CHI,22,1,41.25
WSH,24,2,WSH-CHI-1,CHI,22,1,41.5
WSH,24,2,WSH-CHI-1,CHI,22,1,41.75
WSH,24,2,WSH-CHI-1,CHI,22,1,42.0
WSH,24,2,WSH-CHI-1,CHI,22,1,42.25
WSH,24,2,WSH-CHI-1,CHI,22,1,42.5
WSH,24,2,WSH-CHI-1,CHI,22,1,42.75
WSH,24,2,WSH-CHI-1,CHI,22,1,43.0
WSH,24,2,WSH-CHI-1,CHI,22,1,43.25
WSH,24,2,WSH-CHI-1,CHI,22,1,43.5
WSH,24,2,WSH-CHI-1,CHI,22,1,43.75
WSH,24,2,WSH-CHI-1,CHI,22,1,44.0
WSH,24,2,WSH-CHI-1,CHI,22,1,44.25
WSH,24,2,WSH-CHI-1,CHI,22,1,44.5
WSH,24,2,WSH-CHI-1,CHI,22,1,44.75
WSH,24,2,WSH-CHI-1,CHI,22,1,45.0
WSH,24,2,WSH-CHI-1,CHI,22,1,45.25
WSH,24,2,WSH-CHI-1,CHI,22,1,45.5
WSH,24,2,WSH-CHI-1,CHI,22,1,45.75
WSH,24,2,WSH-CHI-1,CHI,22,1,46.0
WSH,24,2,WSH-CHI-1,CHI,22,1,46.25
WSH,24,2,WSH-CHI-1,CHI,22,1,46.5
WSH,24,2,WSH-CHI-1,CHI,22,1,46.75
WSH,24,2,WSH-CHI-1,CHI,22,1,47.0
WSH,24,2,WSH-CHI-1,CHI,22,1,47.25
WSH,24,2,WSH-CHI-1,CHI,22,1,47.5
WSH,24,2,WSH-CHI-1,CHI,22,1,47.75
WSH,24,2,WSH-CHI-1,CHI,22,1,48.0
WSH,24,2,WSH-CHI-1,CHI,22,1,48.25
WSH,24,2,WSH-CHI-1,CHI,22,1,48.5
WSH,24,2,WSH-CHI-1,CHI,22,1,48.75
POR,2,2,POR-HOU-1,HOU,0,1,0.0
POR,2,2,POR-HOU-1,HOU,0,1,0.25
POR,2,0,POR-HOU-1,HOU,2,1,0.5
POR,2,0,POR-HOU-1,HOU,2,1,0.75
POR,2,-2,POR-HOU-1,HOU,4,1,1.0
POR,2,-2,POR-HOU-1,HOU,4,1,1.25
POR,2,-2,POR-HOU-1,HOU,4,1,1.5
POR,4,0,POR-HOU-1,HOU,4,1,1.75
POR,4,0,POR-HOU-1,HOU,4,1,2.0
POR,6,2,POR-HOU-1,HOU,4,1,2.25
POR,6,2,POR-HOU-1,HOU,4,1,2.5
POR,7,3,POR-HOU-1,HOU,4,1,2.75
POR,7,3,POR-HOU-1,HOU,4,1,3.0
POR,7,3,POR-HOU-1,HOU,4,1,3.25
POR,8,2,POR-HOU-1,HOU,6,1,3.5
POR,8,2,POR-HOU-1,HOU,6,1,3.75
POR,10,4,POR-HOU-1,HOU,6,1,4.0
POR,12,6,POR-HOU-1,HOU,6,1,4.25
POR,12,6,POR-HOU-1,HOU,6,1,4.5
POR,12,4,POR-HOU-1,HOU,8,1,4.75
POR,12,4,POR-HOU-1,HOU,8,1,5.0
POR,14,6,POR-HOU-1,HOU,8,1,5.25
POR,14,6,POR-HOU-1,HOU,8,1,5.5
POR,15,7,POR-HOU-1,HOU,8,1,5.75
POR,15,7,POR-HOU-1,HOU,8,1,6.0
POR,15,5,POR-HOU-1,HOU,10,1,6.25
POR,15,2,POR-HOU-1,HOU,13,1,6.5
POR,15,2,POR-HOU-1,HOU,13,1,6.75
POR,16,3,POR-HOU-1,HOU,13,1,7.0
POR,17,2,POR-HOU-1,HOU,15,1,7.25
POR,19,4,POR-HOU-1,HOU,15,1,7.5
POR,19,4,POR-HOU-1,HOU,15,1,7.75
POR,21,6,POR-HOU-1,HOU,15,1,8.0
POR,21,6,POR-HOU-1,HOU,15,1,8.25
POR,21,6,POR-HOU-1,HOU,15,1,8.5
POR,21,4,POR-HOU-1,HOU,17,1,8.75
POR,21,4,POR-HOU-1,HOU,17,1,9.0
POR,22,5,POR-HOU-1,HOU,17,1,9.25
POR,25,8,POR-HOU-1,HOU,17,1,9.5
POR,25,8,POR-HOU-1,HOU,17,1,9.75
POR,25,8,POR-HOU-1,HOU,17,1,10.0
POR,25,8,POR-HOU-1,HOU,17,1,10.25
POR,25,8,POR-HOU-1,HOU,17,1,10.5
POR,25,8,POR-HOU-1,HOU,17,1,10.75
POR,25,5,POR-HOU-1,HOU,20,1,11.0
POR,25,5,POR-HOU-1,HOU,20,1,11.25
POR,27,7,POR-HOU-1,HOU,20,1,11.5
POR,27,7,POR-HOU-1,HOU,20,1,11.75
POR,27,7,POR-HOU-1,HOU,20,1,12.0
POR,27,7,POR-HOU-1,HOU,20,1,12.25
POR,27,7,POR-HOU-1,HOU,20,1,12.5
POR,27,7,POR-HOU-1,HOU,20,1,12.75
POR,27,7,POR-HOU-1,HOU,20,1,13.0
POR,27,7,POR-HOU-1,HOU,20,1,13.25
POR,27,7,POR-HOU-1,HOU,20,1,13.5
POR,27,7,POR-HOU-1,HOU,20,1,13.75
POR,27,7,POR-HOU-1,HOU,20,1,14.0
POR,27,7,POR-HOU-1,HOU,20,1,14.25
POR,27,7,POR-HOU-1,HOU,20,1,14.5
POR,27,7,POR-HOU-1,HOU,20,1,14.75
POR,27,7,POR-HOU-1,HOU,20,1,15.0
POR,27,7,POR-HOU-1,HOU,20,1,15.25
POR,27,7,POR-HOU-1,HOU,20,1,15.5
POR,27,7,POR-HOU-1,HOU,20,1,15.75
POR,27,7,POR-HOU-1,HOU,20,1,16.0
POR,27,7,POR-HOU-1,HOU,20,1,16.25
POR,27,7,POR-HOU-1,HOU,20,1,16.5
POR,27,7,POR-HOU-1,HOU,20,1,16.75
POR,27,7,POR-HOU-1,HOU,20,1,17.0
POR,27,7,POR-HOU-1,HOU,20,1,17.25
POR,27,7,POR-HOU-1,HOU,20,1,17.5
POR,27,7,POR-HOU-1,HOU,20,1,17.75
POR,27,7,POR-HOU-1,HOU,20,1,18.0
POR,27,7,POR-HOU-1,HOU,20,1,18.25
POR,27,7,POR-HOU-1,HOU,20,1,18.5
POR,27,7,POR-HOU-1,HOU,20,1,18.75
POR,27,7,POR-HOU-1,HOU,20,1,19.0
POR,27,7,POR-HOU-1,HOU,20,1,19.25
POR,27,7,POR-HOU-1,HOU,20,1,19.5
POR,27,7,POR-HOU-1,HOU,20,1,19.75
POR,27,7,POR-HOU-1,HOU,20,1,20.0
POR,27,7,POR-HOU-1,HOU,20,1,20.25
POR,27,7,POR-HOU-1,HOU,20,1,20.5
POR,27,7,POR-HOU-1,HOU,20,1,20.75
POR,27,7,POR-HOU-1,HOU,20,1,21.0
POR,27,7,POR-HOU-1,HOU,20,1,21.25
POR,27,7,POR-HOU-1,HOU,20,1,21.5
POR,27,7,POR-HOU-1,HOU,20,1,21.75
POR,27,7,POR-HOU-1,HOU,20,1,22.0
POR,27,7,POR-HOU-1,HOU,20,1,22.25
POR,27,7,POR-HOU-1,HOU,20,1,22.5
POR,27,7,POR-HOU-1,HOU,20,1,22.75
POR,27,7,POR-HOU-1,HOU,20,1,23.0
POR,27,7,POR-HOU-1,HOU,20,1,23.25
POR,27,7,POR-HOU-1,HOU,20,1,23.5
POR,27,7,POR-HOU-1,HOU,20,1,23.75
POR,27,7,POR-HOU-1,HOU,20,1,24.0
POR,27,7,POR-HOU-1,HOU,20,1,24.25
POR,27,7,POR-HOU-1,HOU,20,1,24.5
POR,27,7,POR-HOU-1,HOU,20,1,24.75
POR,27,7,POR-HOU-1,HOU,20,1,25.0
POR,27,7,POR-HOU-1,HOU,20,1,25.25
POR,27,7,POR-HOU-1,HOU,20,1,25.5
POR,27,7,POR-HOU-1,HOU,20,1,25.75
POR,27,7,POR-HOU-1,HOU,20,1,26.0
POR,27,7,POR-HOU-1,HOU,20,1,26.25
POR,27,7,POR-HOU-1,HOU,20,1,26.5
POR,27,7,POR-HOU-1,HOU,20,1,26.75
POR,27,7,POR-HOU-1,HOU,20,1,27.0
POR,27,7,POR-HOU-1,HOU,20,1,27.25
POR,27,7,POR-HOU-1,HOU,20,1,27.5
POR,27,7,POR-HOU-1,HOU,20,1,27.75
POR,27,7,POR-HOU-1,HOU,20,1,28.0
POR,27,7,POR-HOU-1,HOU,20,1,28.25
POR,27,7,POR-HOU-1,HOU,20,1,28.5
POR,27,7,POR-HOU-1,HOU,20,1,28.75
POR,27,7,POR-HOU-1,HOU,20,1,29.0
POR,27,7,POR-HOU-1,HOU,20,1,29.25
POR,27,7,POR-HOU-1,HOU,20,1,29.5
POR,27,7,POR-HOU-1,HOU,20,1,29.75
POR,27,7,POR-HOU-1,HOU,20,1,30.0
POR,27,7,POR-HOU-1,HOU,20,1,30.25
POR,27,7,POR-HOU-1,HOU,20,1,30.5
POR,27,7,POR-HOU-1,HOU,20,1,30.75
POR,27,7,POR-HOU-1,HOU,20,1,31.0
POR,27,7,POR-HOU-1,HOU,20,1,31.25
POR,27,7,POR-HOU-1,HOU,20,1,31.5
POR,27,7,POR-HOU-1,HOU,20,1,31.75
POR,27,7,POR-HOU-1,HOU,20,1,32.0
POR,27,7,POR-HOU-1,HOU,20,1,32.25
POR,27,7,POR-HOU-1,HOU,20,1,32.5
POR,27,7,POR-HOU-1,HOU,20,1,32.75
POR,27,7,POR-HOU-1,HOU,20,1,33.0
POR,27,7,POR-HOU-1,HOU,20,1,33.25
POR,27,7,POR-HOU-1,HOU,20,1,33.5
POR,27,7,POR-HOU-1,HOU,20,1,33.75
POR,27,7,POR-HOU-1,HOU,20,1,34.0
POR,27,7,POR-HOU-1,HOU,20,1,34.25
POR,27,7,POR-HOU-1,HOU,20,1,34.5
POR,27,7,POR-HOU-1,HOU,20,1,34.75
POR,27,7,POR-HOU-1,HOU,20,1,35.0
POR,27,7,POR-HOU-1,HOU,20,1,35.25
POR,27,7,POR-HOU-1,HOU,20,1,35.5
POR,27,7,POR-HOU-1,HOU,20,1,35.75
POR,27,7,POR-HOU-1,HOU,20,1,36.0
POR,27,7,POR-HOU-1,HOU,20,1,36.25
POR,27,7,POR-HOU-1,HOU,20,1,36.5
POR,27,7,POR-HOU-1,HOU,20,1,36.75
POR,27,7,POR-HOU-1,HOU,20,1,37.0
POR,27,7,POR-HOU-1,HOU,20,1,37.25
POR,27,7,POR-HOU-1,HOU,20,1,37.5
POR,27,7,POR-HOU-1,HOU,20,1,37.75
POR,27,7,POR-HOU-1,HOU,20,1,38.0
POR,27,7,POR-HOU-1,HOU,20,1,38.25
POR,27,7,POR-HOU-1,HOU,20,1,38.5
POR,27,7,POR-HOU-1,HOU,20,1,38.75
POR,27,7,POR-HOU-1,HOU,20,1,39.0
POR,27,7,POR-HOU-1,HOU,20,1,39.25
POR,27,7,POR-HOU-1,HOU,20,1,39.5
POR,27,7,POR-HOU-1,HOU,20,1,39.75
POR,27,7,POR-HOU-1,HOU,20,1,40.0
POR,27,7,POR-HOU-1,HOU,20,1,40.25
POR,27,7,POR-HOU-1,HOU,20,1,40.5
POR,27,7,POR-HOU-1,HOU,20,1,40.75
POR,27,7,POR-HOU-1,HOU,20,1,41.0
POR,27,7,POR-HOU-1,HOU,20,1,41.25
POR,27,7,POR-HOU-1,HOU,20,1,41.5
POR,27,7,POR-HOU-1,HOU,20,1,41.75
POR,27,7,POR-HOU-1,HOU,20,1,42.0
POR,27,7,POR-HOU-1,HOU,20,1,42.25
POR,27,7,POR-HOU-1,HOU,20,1,42.5
POR,27,7,POR-HOU-1,HOU,20,1,42.75
POR,27,7,POR-HOU-1,HOU,20,1,43.0
POR,27,7,POR-HOU-1,HOU,20,1,43.25
POR,27,7,POR-HOU-1,HOU,20,1,43.5
POR,27,7,POR-HOU-1,HOU,20,1,43.75
POR,27,7,POR-HOU-1,HOU,20,1,44.0
POR,27,7,POR-HOU-1,HOU,20,1,44.25
POR,27,7,POR-HOU-1,HOU,20,1,44.5
POR,27,7,POR-HOU-1,HOU,20,1,44.75
POR,27,7,POR-HOU-1,HOU,20,1,45.0
POR,27,7,POR-HOU-1,HOU,20,1,45.25
POR,27,7,POR-HOU-1,HOU,20,1,45.5
POR,27,7,POR-HOU-1,HOU,20,1,45.75
POR,27,7,POR-HOU-1,HOU,20,1,46.0
POR,27,7,POR-HOU-1,HOU,20,1,46.25
POR,27,7,POR-HOU-1,HOU,20,1,46.5
POR,27,7,POR-HOU-1,HOU,20,1,46.75
POR,27,7,POR-HOU-1,HOU,20,1,47.0
POR,27,7,POR-HOU-1,HOU,20,1,47.25
POR,27,7,POR-HOU-1,HOU,20,1,47.5
POR,27,7,POR-HOU-1,HOU,20,1,47.75
POR,27,7,POR-HOU-1,HOU,20,1,48.0
POR,27,7,POR-HOU-1,HOU,20,1,48.25
POR,27,7,POR-HOU-1,HOU,20,1,48.5
POR,27,7,POR-HOU-1,HOU,20,1,48.75
MEM,2,2,MEM-OKC-2,OKC,0,1,0.0
MEM,2,2,MEM-OKC-2,OKC,0,1,0.25
MEM,2,2,MEM-OKC-2,OKC,0,1,0.5
MEM,2,2,MEM-OKC-2,OKC,0,1,0.75
MEM,2,2,MEM-OKC-2,OKC,0,1,1.0
MEM,2,1,MEM-OKC-2,OKC,1,1,1.25
MEM,4,2,MEM-OKC-2,OKC,2,1,1.5
MEM,4,2,MEM-OKC-2,OKC,2,1,1.75
MEM,4,2,MEM-OKC-2,OKC,2,1,2.0
MEM,4,2,MEM-OKC-2,OKC,2,1,2.25
MEM,4,2,MEM-OKC-2,OKC,2,1,2.5
MEM,4,2,MEM-OKC-2,OKC,2,1,2.75
MEM,4,2,MEM-OKC-2,OKC,2,1,3.0
MEM,4,0,MEM-OKC-2,OKC,4,1,3.25
MEM,4,0,MEM-OKC-2,OKC,4,1,3.5
MEM,4,0,MEM-OKC-2,OKC,4,1,3.75
MEM,4,-2,MEM-OKC-2,OKC,6,1,4.0
MEM,6,0,MEM-OKC-2,OKC,6,1,4.25
MEM,6,0,MEM-OKC-2,OKC,6,1,4.5
MEM,6,0,MEM-OKC-2,OKC,6,1,4.75
MEM,6,0,MEM-OKC-2,OKC,6,1,5.0
MEM,6,0,MEM-OKC-2,OKC,6,1,5.25
MEM,8,2,MEM-OKC-2,OKC,6,1,5.5
MEM,8,1,MEM-OKC-2,OKC,7,1,5.75
MEM,9,1,MEM-OKC-2,OKC,8,1,6.0
MEM,9,1,MEM-OKC-2,OKC,8,1,6.25
MEM,9,1,MEM-OKC-2,OKC,8,1,6.5
MEM,9,1,MEM-OKC-2,OKC,8,1,6.75
MEM,12,4,MEM-OKC-2,OKC,8,1,7.0
MEM,12,4,MEM-OKC-2,OKC,8,1,7.25
MEM,12,4,MEM-OKC-2,OKC,8,1,7.5
MEM,14,6,MEM-OKC-2,OKC,8,1,7.75
MEM,14,4,MEM-OKC-2,OKC,10,1,8.0
MEM,16,6,MEM-OKC-2,OKC,10,1,8.25
MEM,16,4,MEM-OKC-2,OKC,12,1,8.5
MEM,16,4,MEM-OKC-2,OKC,12,1,8.75
MEM,18,6,MEM-OKC-2,OKC,12,1,9.0
MEM,18,6,MEM-OKC-2,OKC,12,1,9.25
MEM,18,6,MEM-OKC-2,OKC,12,1,9.5
MEM,20,8,MEM-OKC-2,OKC,12,1,9.75
MEM,20,8,MEM-OKC-2,OKC,12,1,10.0
MEM,20,8,MEM-OKC-2,OKC,12,1,10.25
MEM,20,7,MEM-OKC-2,OKC,13,1,10.5
MEM,22,8,MEM-OKC-2,OKC,14,1,10.75
MEM,22,8,MEM-OKC-2,OKC,14,1,11.0
MEM,23,9,MEM-OKC-2,OKC,14,1,11.25
MEM,24,8,MEM-OKC-2,OKC,16,1,11.5
MEM,24,8,MEM-OKC-2,OKC,16,1,11.75
MEM,24,8,MEM-OKC-2,OKC,16,1,12.0
MEM,24,8,MEM-OKC-2,OKC,16,1,12.25
MEM,24,8,MEM-OKC-2,OKC,16,1,12.5
MEM,24,8,MEM-OKC-2,OKC,16,1,12.75
MEM,24,8,MEM-OKC-2,OKC,16,1,13.0
MEM,24,8,MEM-OKC-2,OKC,16,1,13.25
MEM,24,8,MEM-OKC-2,OKC,16,1,13.5
MEM,24,8,MEM-OKC-2,OKC,16,1,13.75
MEM,24,8,MEM-OKC-2,OKC,16,1,14.0
MEM,24,8,MEM-OKC-2,OKC,16,1,14.25
MEM,24,8,MEM-OKC-2,OKC,16,1,14.5
MEM,24,8,MEM-OKC-2,OKC,16,1,14.75
MEM,24,8,MEM-OKC-2,OKC,16,1,15.0
MEM,24,8,MEM-OKC-2,OKC,16,1,15.25
MEM,24,8,MEM-OKC-2,OKC,16,1,15.5
MEM,24,8,MEM-OKC-2,OKC,16,1,15.75
MEM,24,8,MEM-OKC-2,OKC,16,1,16.0
MEM,24,8,MEM-OKC-2,OKC,16,1,16.25
MEM,24,8,MEM-OKC-2,OKC,16,1,16.5
MEM,24,8,MEM-OKC-2,OKC,16,1,16.75
MEM,24,8,MEM-OKC-2,OKC,16,1,17.0
MEM,24,8,MEM-OKC-2,OKC,16,1,17.25
MEM,24,8,MEM-OKC-2,OKC,16,1,17.5
MEM,24,8,MEM-OKC-2,OKC,16,1,17.75
MEM,24,8,MEM-OKC-2,OKC,16,1,18.0
MEM,24,8,MEM-OKC-2,OKC,16,1,18.25
MEM,24,8,MEM-OKC-2,OKC,16,1,18.5
MEM,24,8,MEM-OKC-2,OKC,16,1,18.75
MEM,24,8,MEM-OKC-2,OKC,16,1,19.0
MEM,24,8,MEM-OKC-2,OKC,16,1,19.25
MEM,24,8,MEM-OKC-2,OKC,16,1,19.5
MEM,24,8,MEM-OKC-2,OKC,16,1,19.75
MEM,24,8,MEM-OKC-2,OKC,16,1,20.0
MEM,24,8,MEM-OKC-2,OKC,16,1,20.25
MEM,24,8,MEM-OKC-2,OKC,16,1,20.5
MEM,24,8,MEM-OKC-2,OKC,16,1,20.75
MEM,24,8,MEM-OKC-2,OKC,16,1,21.0
MEM,24,8,MEM-OKC-2,OKC,16,1,21.25
MEM,24,8,MEM-OKC-2,OKC,16,1,21.5
MEM,24,8,MEM-OKC-2,OKC,16,1,21.75
MEM,24,8,MEM-OKC-2,OKC,16,1,22.0
MEM,24,8,MEM-OKC-2,OKC,16,1,22.25
MEM,24,8,MEM-OKC-2,OKC,16,1,22.5
MEM,24,8,MEM-OKC-2,OKC,16,1,22.75
MEM,24,8,MEM-OKC-2,OKC,16,1,23.0
MEM,24,8,MEM-OKC-2,OKC,16,1,23.25
MEM,24,8,MEM-OKC-2,OKC,16,1,23.5
MEM,24,8,MEM-OKC-2,OKC,16,1,23.75
MEM,24,8,MEM-OKC-2,OKC,16,1,24.0
MEM,24,8,MEM-OKC-2,OKC,16,1,24.25
MEM,24,8,MEM-OKC-2,OKC,16,1,24.5
MEM,24,8,MEM-OKC-2,OKC,16,1,24.75
MEM,24,8,MEM-OKC-2,OKC,16,1,25.0
MEM,24,8,MEM-OKC-2,OKC,16,1,25.25
MEM,24,8,MEM-OKC-2,OKC,16,1,25.5
MEM,24,8,MEM-OKC-2,OKC,16,1,25.75
MEM,24,8,MEM-OKC-2,OKC,16,1,26.0
MEM,24,8,MEM-OKC-2,OKC,16,1,26.25
MEM,24,8,MEM-OKC-2,OKC,16,1,26.5
MEM,24,8,MEM-OKC-2,OKC,16,1,26.75
MEM,24,8,MEM-OKC-2,OKC,16,1,27.0
MEM,24,8,MEM-OKC-2,OKC,16,1,27.25
MEM,24,8,MEM-OKC-2,OKC,16,1,27.5
MEM,24,8,MEM-OKC-2,OKC,16,1,27.75
MEM,24,8,MEM-OKC-2,OKC,16,1,28.0
MEM,24,8,MEM-OKC-2,OKC,16,1,28.25
MEM,24,8,MEM-OKC-2,OKC,16,1,28.5
MEM,24,8,MEM-OKC-2,OKC,16,1,28.75
MEM,24,8,MEM-OKC-2,OKC,16,1,29.0
MEM,24,8,MEM-OKC-2,OKC,16,1,29.25
MEM,24,8,MEM-OKC-2,OKC,16,1,29.5
MEM,24,8,MEM-OKC-2,OKC,16,1,29.75
MEM,24,8,MEM-OKC-2,OKC,16,1,30.0
MEM,24,8,MEM-OKC-2,OKC,16,1,30.25
MEM,24,8,MEM-OKC-2,OKC,16,1,30.5
MEM,24,8,MEM-OKC-2,OKC,16,1,30.75
MEM,24,8,MEM-OKC-2,OKC,16,1,31.0
MEM,24,8,MEM-OKC-2,OKC,16,1,31.25
MEM,24,8,MEM-OKC-2,OKC,16,1,31.5
MEM,24,8,MEM-OKC-2,OKC,16,1,31.75
MEM,24,8,MEM-OKC-2,OKC,16,1,32.0
MEM,24,8,MEM-OKC-2,OKC,16,1,32.25
MEM,24,8,MEM-OKC-2,OKC,16,1,32.5
MEM,24,8,MEM-OKC-2,OKC,16,1,32.75
MEM,24,8,MEM-OKC-2,OKC,16,1,33.0
MEM,24,8,MEM-OKC-2,OKC,16,1,33.25
MEM,24,8,MEM-OKC-2,OKC,16,1,33.5
MEM,24,8,MEM-OKC-2,OKC,16,1,33.75
MEM,24,8,MEM-OKC-2,OKC,16,1,34.0
MEM,24,8,MEM-OKC-2,OKC,16,1,34.25
MEM,24,8,MEM-OKC-2,OKC,16,1,34.5
MEM,24,8,MEM-OKC-2,OKC,16,1,34.75
MEM,24,8,MEM-OKC-2,OKC,16,1,35.0
MEM,24,8,MEM-OKC-2,OKC,16,1,35.25
MEM,24,8,MEM-OKC-2,OKC,16,1,35.5
MEM,24,8,MEM-OKC-2,OKC,16,1,35.75
MEM,24,8,MEM-OKC-2,OKC,16,1,36.0
MEM,24,8,MEM-OKC-2,OKC,16,1,36.25
MEM,24,8,MEM-OKC-2,OKC,16,1,36.5
MEM,24,8,MEM-OKC-2,OKC,16,1,36.75
MEM,24,8,MEM-OKC-2,OKC,16,1,37.0
MEM,24,8,MEM-OKC-2,OKC,16,1,37.25
MEM,24,8,MEM-OKC-2,OKC,16,1,37.5
MEM,24,8,MEM-OKC-2,OKC,16,1,37.75
MEM,24,8,MEM-OKC-2,OKC,16,1,38.0
MEM,24,8,MEM-OKC-2,OKC,16,1,38.25
MEM,24,8,MEM-OKC-2,OKC,16,1,38.5
MEM,24,8,MEM-OKC-2,OKC,16,1,38.75
MEM,24,8,MEM-OKC-2,OKC,16,1,39.0
MEM,24,8,MEM-OKC-2,OKC,16,1,39.25
MEM,24,8,MEM-OKC-2,OKC,16,1,39.5
MEM,24,8,MEM-OKC-2,OKC,16,1,39.75
MEM,24,8,MEM-OKC-2,OKC,16,1,40.0
MEM,24,8,MEM-OKC-2,OKC,16,1,40.25
MEM,24,8,MEM-OKC-2,OKC,16,1,40.5
MEM,24,8,MEM-OKC-2,OKC,16,1,40.75
MEM,24,8,MEM-OKC-2,OKC,16,1,41.0
MEM,24,8,MEM-OKC-2,OKC,16,1,41.25
MEM,24,8,MEM-OKC-2,OKC,16,1,41.5
MEM,24,8,MEM-OKC-2,OKC,16,1,41.75
MEM,24,8,MEM-OKC-2,OKC,16,1,42.0
MEM,24,8,MEM-OKC-2,OKC,16,1,42.25
MEM,24,8,MEM-OKC-2,OKC,16,1,42.5
MEM,24,8,MEM-OKC-2,OKC,16,1,42.75
MEM,24,8,MEM-OKC-2,OKC,16,1,43.0
MEM,24,8,MEM-OKC-2,OKC,16,1,43.25
MEM,24,8,MEM-OKC-2,OKC,16,1,43.5
MEM,24,8,MEM-OKC-2,OKC,16,1,43.75
MEM,24,8,MEM-OKC-2,OKC,16,1,44.0
MEM,24,8,MEM-OKC-2,OKC,16,1,44.25
MEM,24,8,MEM-OKC-2,OKC,16,1,44.5
MEM,24,8,MEM-OKC-2,OKC,16,1,44.75
MEM,24,8,MEM-OKC-2,OKC,16,1,45.0
MEM,24,8,MEM-OKC-2,OKC,16,1,45.25
MEM,24,8,MEM-OKC-2,OKC,16,1,45.5
MEM,24,8,MEM-OKC-2,OKC,16,1,45.75
MEM,24,8,MEM-OKC-2,OKC,16,1,46.0
MEM,24,8,MEM-OKC-2,OKC,16,1,46.25
MEM,24,8,MEM-OKC-2,OKC,16,1,46.5
MEM,24,8,MEM-OKC-2,OKC,16,1,46.75
MEM,24,8,MEM-OKC-2,OKC,16,1,47.0
MEM,24,8,MEM-OKC-2,OKC,16,1,47.25
MEM,24,8,MEM-OKC-2,OKC,16,1,47.5
MEM,24,8,MEM-OKC-2,OKC,16,1,47.75
MEM,24,8,MEM-OKC-2,OKC,16,1,48.0
MEM,24,8,MEM-OKC-2,OKC,16,1,48.25
MEM,24,8,MEM-OKC-2,OKC,16,1,48.5
MEM,24,8,MEM-OKC-2,OKC,16,1,48.75
GS,0,-2,GS-LAC-2,LAC,2,1,0.0
GS,0,-2,GS-LAC-2,LAC,2,1,0.25
GS,0,-5,GS-LAC-2,LAC,5,1,0.5
GS,0,-5,GS-LAC-2,LAC,5,1,0.75
GS,2,-3,GS-LAC-2,LAC,5,1,1.0
GS,2,-3,GS-LAC-2,LAC,5,1,1.25
GS,2,-3,GS-LAC-2,LAC,5,1,1.5
GS,2,-5,GS-LAC-2,LAC,7,1,1.75
GS,2,-7,GS-LAC-2,LAC,9,1,2.0
GS,2,-7,GS-LAC-2,LAC,9,1,2.25
GS,2,-7,GS-LAC-2,LAC,9,1,2.5
GS,2,-7,GS-LAC-2,LAC,9,1,2.75
GS,4,-5,GS-LAC-2,LAC,9,1,3.0
GS,4,-6,GS-LAC-2,LAC,10,1,3.25
GS,4,-8,GS-LAC-2,LAC,12,1,3.5
GS,4,-8,GS-LAC-2,LAC,12,1,3.75
GS,4,-10,GS-LAC-2,LAC,14,1,4.0
GS,4,-10,GS-LAC-2,LAC,14,1,4.25
GS,4,-10,GS-LAC-2,LAC,14,1,4.5
GS,4,-10,GS-LAC-2,LAC,14,1,4.75
GS,4,-10,GS-LAC-2,LAC,14,1,5.0
GS,6,-9,GS-LAC-2,LAC,15,1,5.25
GS,6,-11,GS-LAC-2,LAC,17,1,5.5
GS,9,-8,GS-LAC-2,LAC,17,1,5.75
GS,10,-7,GS-LAC-2,LAC,17,1,6.0
GS,10,-7,GS-LAC-2,LAC,17,1,6.25
GS,11,-8,GS-LAC-2,LAC,19,1,6.5
GS,11,-8,GS-LAC-2,LAC,19,1,6.75
GS,11,-8,GS-LAC-2,LAC,19,1,7.0
GS,11,-10,GS-LAC-2,LAC,21,1,7.25
GS,11,-10,GS-LAC-2,LAC,21,1,7.5
GS,11,-10,GS-LAC-2,LAC,21,1,7.75
GS,13,-8,GS-LAC-2,LAC,21,1,8.0
GS,13,-10,GS-LAC-2,LAC,23,1,8.25
GS,13,-10,GS-LAC-2,LAC,23,1,8.5
GS,13,-12,GS-LAC-2,LAC,25,1,8.75
GS,16,-9,GS-LAC-2,LAC,25,1,9.0
GS,16,-9,GS-LAC-2,LAC,25,1,9.25
GS,16,-9,GS-LAC-2,LAC,25,1,9.5
GS,18,-7,GS-LAC-2,LAC,25,1,9.75
GS,18,-7,GS-LAC-2,LAC,25,1,10.0
GS,18,-7,GS-LAC-2,LAC,25,1,10.25
GS,18,-9,GS-LAC-2,LAC,27,1,10.5
GS,18,-10,GS-LAC-2,LAC,28,1,10.75
GS,20,-9,GS-LAC-2,LAC,29,1,11.0
GS,20,-11,GS-LAC-2,LAC,31,1,11.25
GS,20,-11,GS-LAC-2,LAC,31,1,11.5
GS,20,-11,GS-LAC-2,LAC,31,1,11.75
GS,20,-11,GS-LAC-2,LAC,31,1,12.0
GS,20,-11,GS-LAC-2,LAC,31,1,12.25
GS,20,-11,GS-LAC-2,LAC,31,1,12.5
GS,20,-11,GS-LAC-2,LAC,31,1,12.75
GS,20,-11,GS-LAC-2,LAC,31,1,13.0
GS,20,-11,GS-LAC-2,LAC,31,1,13.25
GS,20,-11,GS-LAC-2,LAC,31,1,13.5
GS,20,-11,GS-LAC-2,LAC,31,1,13.75
GS,20,-11,GS-LAC-2,LAC,31,1,14.0
GS,20,-11,GS-LAC-2,LAC,31,1,14.25
GS,20,-11,GS-LAC-2,LAC,31,1,14.5
GS,20,-11,GS-LAC-2,LAC,31,1,14.75
GS,20,-11,GS-LAC-2,LAC,31,1,15.0
GS,20,-11,GS-LAC-2,LAC,31,1,15.25
GS,20,-11,GS-LAC-2,LAC,31,1,15.5
GS,20,-11,GS-LAC-2,LAC,31,1,15.75
GS,20,-11,GS-LAC-2,LAC,31,1,16.0
GS,20,-11,GS-LAC-2,LAC,31,1,16.25
GS,20,-11,GS-LAC-2,LAC,31,1,16.5
GS,20,-11,GS-LAC-2,LAC,31,1,16.75
GS,20,-11,GS-LAC-2,LAC,31,1,17.0
GS,20,-11,GS-LAC-2,LAC,31,1,17.25
GS,20,-11,GS-LAC-2,LAC,31,1,17.5
GS,20,-11,GS-LAC-2,LAC,31,1,17.75
GS,20,-11,GS-LAC-2,LAC,31,1,18.0
GS,20,-11,GS-LAC-2,LAC,31,1,18.25
GS,20,-11,GS-LAC-2,LAC,31,1,18.5
GS,20,-11,GS-LAC-2,LAC,31,1,18.75
GS,20,-11,GS-LAC-2,LAC,31,1,19.0
GS,20,-11,GS-LAC-2,LAC,31,1,19.25
GS,20,-11,GS-LAC-2,LAC,31,1,19.5
GS,20,-11,GS-LAC-2,LAC,31,1,19.75
GS,20,-11,GS-LAC-2,LAC,31,1,20.0
GS,20,-11,GS-LAC-2,LAC,31,1,20.25
GS,20,-11,GS-LAC-2,LAC,31,1,20.5
GS,20,-11,GS-LAC-2,LAC,31,1,20.75
GS,20,-11,GS-LAC-2,LAC,31,1,21.0
GS,20,-11,GS-LAC-2,LAC,31,1,21.25
GS,20,-11,GS-LAC-2,LAC,31,1,21.5
GS,20,-11,GS-LAC-2,LAC,31,1,21.75
GS,20,-11,GS-LAC-2,LAC,31,1,22.0
GS,20,-11,GS-LAC-2,LAC,31,1,22.25
GS,20,-11,GS-LAC-2,LAC,31,1,22.5
GS,20,-11,GS-LAC-2,LAC,31,1,22.75
GS,20,-11,GS-LAC-2,LAC,31,1,23.0
GS,20,-11,GS-LAC-2,LAC,31,1,23.25
GS,20,-11,GS-LAC-2,LAC,31,1,23.5
GS,20,-11,GS-LAC-2,LAC,31,1,23.75
GS,20,-11,GS-LAC-2,LAC,31,1,24.0
GS,20,-11,GS-LAC-2,LAC,31,1,24.25
GS,20,-11,GS-LAC-2,LAC,31,1,24.5
GS,20,-11,GS-LAC-2,LAC,31,1,24.75
GS,20,-11,GS-LAC-2,LAC,31,1,25.0
GS,20,-11,GS-LAC-2,LAC,31,1,25.25
GS,20,-11,GS-LAC-2,LAC,31,1,25.5
GS,20,-11,GS-LAC-2,LAC,31,1,25.75
GS,20,-11,GS-LAC-2,LAC,31,1,26.0
GS,20,-11,GS-LAC-2,LAC,31,1,26.25
GS,20,-11,GS-LAC-2,LAC,31,1,26.5
GS,20,-11,GS-LAC-2,LAC,31,1,26.75
GS,20,-11,GS-LAC-2,LAC,31,1,27.0
GS,20,-11,GS-LAC-2,LAC,31,1,27.25
GS,20,-11,GS-LAC-2,LAC,31,1,27.5
GS,20,-11,GS-LAC-2,LAC,31,1,27.75
GS,20,-11,GS-LAC-2,LAC,31,1,28.0
GS,20,-11,GS-LAC-2,LAC,31,1,28.25
GS,20,-11,GS-LAC-2,LAC,31,1,28.5
GS,20,-11,GS-LAC-2,LAC,31,1,28.75
GS,20,-11,GS-LAC-2,LAC,31,1,29.0
GS,20,-11,GS-LAC-2,LAC,31,1,29.25
GS,20,-11,GS-LAC-2,LAC,31,1,29.5
GS,20,-11,GS-LAC-2,LAC,31,1,29.75
GS,20,-11,GS-LAC-2,LAC,31,1,30.0
GS,20,-11,GS-LAC-2,LAC,31,1,30.25
GS,20,-11,GS-LAC-2,LAC,31,1,30.5
GS,20,-11,GS-LAC-2,LAC,31,1,30.75
GS,20,-11,GS-LAC-2,LAC,31,1,31.0
GS,20,-11,GS-LAC-2,LAC,31,1,31.25
GS,20,-11,GS-LAC-2,LAC,31,1,31.5
GS,20,-11,GS-LAC-2,LAC,31,1,31.75
GS,20,-11,GS-LAC-2,LAC,31,1,32.0
GS,20,-11,GS-LAC-2,LAC,31,1,32.25
GS,20,-11,GS-LAC-2,LAC,31,1,32.5
GS,20,-11,GS-LAC-2,LAC,31,1,32.75
GS,20,-11,GS-LAC-2,LAC,31,1,33.0
GS,20,-11,GS-LAC-2,LAC,31,1,33.25
GS,20,-11,GS-LAC-2,LAC,31,1,33.5
GS,20,-11,GS-LAC-2,LAC,31,1,33.75
GS,20,-11,GS-LAC-2,LAC,31,1,34.0
GS,20,-11,GS-LAC-2,LAC,31,1,34.25
GS,20,-11,GS-LAC-2,LAC,31,1,34.5
GS,20,-11,GS-LAC-2,LAC,31,1,34.75
GS,20,-11,GS-LAC-2,LAC,31,1,35.0
GS,20,-11,GS-LAC-2,LAC,31,1,35.25
GS,20,-11,GS-LAC-2,LAC,31,1,35.5
GS,20,-11,GS-LAC-2,LAC,31,1,35.75
GS,20,-11,GS-LAC-2,LAC,31,1,36.0
GS,20,-11,GS-LAC-2,LAC,31,1,36.25
GS,20,-11,GS-LAC-2,LAC,31,1,36.5
GS,20,-11,GS-LAC-2,LAC,31,1,36.75
GS,20,-11,GS-LAC-2,LAC,31,1,37.0
GS,20,-11,GS-LAC-2,LAC,31,1,37.25
GS,20,-11,GS-LAC-2,LAC,31,1,37.5
GS,20,-11,GS-LAC-2,LAC,31,1,37.75
GS,20,-11,GS-LAC-2,LAC,31,1,38.0
GS,20,-11,GS-LAC-2,LAC,31,1,38.25
GS,20,-11,GS-LAC-2,LAC,31,1,38.5
GS,20,-11,GS-LAC-2,LAC,31,1,38.75
GS,20,-11,GS-LAC-2,LAC,31,1,39.0
GS,20,-11,GS-LAC-2,LAC,31,1,39.25
GS,20,-11,GS-LAC-2,LAC,31,1,39.5
GS,20,-11,GS-LAC-2,LAC,31,1,39.75
GS,20,-11,GS-LAC-2,LAC,31,1,40.0
GS,20,-11,GS-LAC-2,LAC,31,1,40.25
GS,20,-11,GS-LAC-2,LAC,31,1,40.5
GS,20,-11,GS-LAC-2,LAC,31,1,40.75
GS,20,-11,GS-LAC-2,LAC,31,1,41.0
GS,20,-11,GS-LAC-2,LAC,31,1,41.25
GS,20,-11,GS-LAC-2,LAC,31,1,41.5
GS,20,-11,GS-LAC-2,LAC,31,1,41.75
GS,20,-11,GS-LAC-2,LAC,31,1,42.0
GS,20,-11,GS-LAC-2,LAC,31,1,42.25
GS,20,-11,GS-LAC-2,LAC,31,1,42.5
GS,20,-11,GS-LAC-2,LAC,31,1,42.75
GS,20,-11,GS-LAC-2,LAC,31,1,43.0
GS,20,-11,GS-LAC-2,LAC,31,1,43.25
GS,20,-11,GS-LAC-2,LAC,31,1,43.5
GS,20,-11,GS-LAC-2,LAC,31,1,43.75
GS,20,-11,GS-LAC-2,LAC,31,1,44.0
GS,20,-11,GS-LAC-2,LAC,31,1,44.25
GS,20,-11,GS-LAC-2,LAC,31,1,44.5
GS,20,-11,GS-LAC-2,LAC,31,1,44.75
GS,20,-11,GS-LAC-2,LAC,31,1,45.0
GS,20,-11,GS-LAC-2,LAC,31,1,45.25
GS,20,-11,GS-LAC-2,LAC,31,1,45.5
GS,20,-11,GS-LAC-2,LAC,31,1,45.75
GS,20,-11,GS-LAC-2,LAC,31,1,46.0
GS,20,-11,GS-LAC-2,LAC,31,1,46.25
GS,20,-11,GS-LAC-2,LAC,31,1,46.5
GS,20,-11,GS-LAC-2,LAC,31,1,46.75
GS,20,-11,GS-LAC-2,LAC,31,1,47.0
GS,20,-11,GS-LAC-2,LAC,31,1,47.25
GS,20,-11,GS-LAC-2,LAC,31,1,47.5
GS,20,-11,GS-LAC-2,LAC,31,1,47.75
GS,20,-11,GS-LAC-2,LAC,31,1,48.0
GS,20,-11,GS-LAC-2,LAC,31,1,48.25
GS,20,-11,GS-LAC-2,LAC,31,1,48.5
GS,20,-11,GS-LAC-2,LAC,31,1,48.75
